Contest,Candidate Issue,Party,District Name,Affidavit Votes,Absentee Votes,Early Votes,Election Day Votes,Total Votes,% of Total Votes
"PRESIDENT OF THE UNITED STATES ",Pete Buttigieg,DM1,"City of Plattsburgh Ward 1 1 ",0,0,0,1,1,2.04
"PRESIDENT OF THE UNITED STATES ",Pete Buttigieg,DM1,"City of Plattsburgh Ward 1 2 ",0,5,0,2,7,2.63
"PRESIDENT OF THE UNITED STATES ",Pete Buttigieg,DM1,"City of Plattsburgh Ward 1 3 ",0,1,0,0,1,14.29
"PRESIDENT OF THE UNITED STATES ",Pete Buttigieg,DM1,"City of Plattsburgh Ward 2 1 ",0,0,0,1,1,1.10
"PRESIDENT OF THE UNITED STATES ",Pete Buttigieg,DM1,"City of Plattsburgh Ward 2 2 ",0,1,0,1,2,4.08
"PRESIDENT OF THE UNITED STATES ",Pete Buttigieg,DM1,"City of Plattsburgh Ward 3 1 ",0,1,0,2,3,2.19
"PRESIDENT OF THE UNITED STATES ",Pete Buttigieg,DM1,"City of Plattsburgh Ward 3 2 ",0,3,0,2,5,2.73
"PRESIDENT OF THE UNITED STATES ",Pete Buttigieg,DM1,"City of Plattsburgh Ward 4 1 ",0,1,0,2,3,1.71
"PRESIDENT OF THE UNITED STATES ",Pete Buttigieg,DM1,"City of Plattsburgh Ward 4 2 ",0,1,0,3,4,2.29
"PRESIDENT OF THE UNITED STATES ",Pete Buttigieg,DM1,"City of Plattsburgh Ward 5 1 ",0,1,0,0,1,0.88
"PRESIDENT OF THE UNITED STATES ",Pete Buttigieg,DM1,"City of Plattsburgh Ward 5 2 ",0,1,0,1,2,1.16
"PRESIDENT OF THE UNITED STATES ",Pete Buttigieg,DM1,"City of Plattsburgh Ward 6 1 ",0,0,0,0,0,0.00
"PRESIDENT OF THE UNITED STATES ",Pete Buttigieg,DM1,"City of Plattsburgh Ward 6 2 ",0,0,0,1,1,1.18
"PRESIDENT OF THE UNITED STATES ",Pete Buttigieg,DM1,"Town of Altona 1 ",0,2,0,1,3,3.66
"PRESIDENT OF THE UNITED STATES ",Pete Buttigieg,DM1,"Town of AuSable 1 ",0,4,0,1,5,9.62
"PRESIDENT OF THE UNITED STATES ",Pete Buttigieg,DM1,"Town of AuSable 2 ",0,2,0,0,2,3.13
"PRESIDENT OF THE UNITED STATES ",Pete Buttigieg,DM1,"Town of Beekmantown 1 ",0,0,0,2,2,3.08
"PRESIDENT OF THE UNITED STATES ",Pete Buttigieg,DM1,"Town of Beekmantown 2 ",0,0,0,0,0,0.00
"PRESIDENT OF THE UNITED STATES ",Pete Buttigieg,DM1,"Town of Beekmantown 3 ",0,1,0,1,2,1.46
"PRESIDENT OF THE UNITED STATES ",Pete Buttigieg,DM1,"Town of Beekmantown 4 ",0,1,0,0,1,1.37
"PRESIDENT OF THE UNITED STATES ",Pete Buttigieg,DM1,"Town of Black Brook 1 ",0,0,0,1,1,2.04
"PRESIDENT OF THE UNITED STATES ",Pete Buttigieg,DM1,"Town of Black Brook 2 ",0,2,0,0,2,10.53
"PRESIDENT OF THE UNITED STATES ",Pete Buttigieg,DM1,"Town of Champlain 1 ",0,0,0,1,1,1.22
"PRESIDENT OF THE UNITED STATES ",Pete Buttigieg,DM1,"Town of Champlain 2 ",0,2,0,1,3,2.86
"PRESIDENT OF THE UNITED STATES ",Pete Buttigieg,DM1,"Town of Champlain 3 ",0,0,0,3,3,3.57
"PRESIDENT OF THE UNITED STATES ",Pete Buttigieg,DM1,"Town of Chazy 1 ",0,1,0,3,4,3.81
"PRESIDENT OF THE UNITED STATES ",Pete Buttigieg,DM1,"Town of Chazy 2 ",0,2,0,0,2,2.17
"PRESIDENT OF THE UNITED STATES ",Pete Buttigieg,DM1,"Town of Clinton 1 ",0,1,0,0,1,3.70
"PRESIDENT OF THE UNITED STATES ",Pete Buttigieg,DM1,"Town of Dannemora 1 ",0,0,0,0,0,0.00
"PRESIDENT OF THE UNITED STATES ",Pete Buttigieg,DM1,"Town of Dannemora 2 ",0,1,0,0,1,4.00
"PRESIDENT OF THE UNITED STATES ",Pete Buttigieg,DM1,"Town of Dannemora 3 ",0,0,0,2,2,5.13
"PRESIDENT OF THE UNITED STATES ",Pete Buttigieg,DM1,"Town of Ellenburg 1 ",0,3,0,2,5,6.76
"PRESIDENT OF THE UNITED STATES ",Pete Buttigieg,DM1,"Town of Mooers 1 ",0,0,0,1,1,1.49
"PRESIDENT OF THE UNITED STATES ",Pete Buttigieg,DM1,"Town of Mooers 2 ",0,0,0,0,0,0.00
"PRESIDENT OF THE UNITED STATES ",Pete Buttigieg,DM1,"Town of Peru 1 ",0,0,0,0,0,0.00
"PRESIDENT OF THE UNITED STATES ",Pete Buttigieg,DM1,"Town of Peru 2 ",0,0,0,0,0,0.00
"PRESIDENT OF THE UNITED STATES ",Pete Buttigieg,DM1,"Town of Peru 3 ",0,0,0,0,0,0.00
"PRESIDENT OF THE UNITED STATES ",Pete Buttigieg,DM1,"Town of Peru 4 ",0,1,0,0,1,0.93
"PRESIDENT OF THE UNITED STATES ",Pete Buttigieg,DM1,"Town of Plattsburgh 1 ",0,3,0,0,3,3.90
"PRESIDENT OF THE UNITED STATES ",Pete Buttigieg,DM1,"Town of Plattsburgh 2 ",0,0,0,0,0,0.00
"PRESIDENT OF THE UNITED STATES ",Pete Buttigieg,DM1,"Town of Plattsburgh 3 ",0,0,0,0,0,0.00
"PRESIDENT OF THE UNITED STATES ",Pete Buttigieg,DM1,"Town of Plattsburgh 4 ",0,3,0,1,4,4.82
"PRESIDENT OF THE UNITED STATES ",Pete Buttigieg,DM1,"Town of Plattsburgh 5 ",0,1,0,0,1,1.64
"PRESIDENT OF THE UNITED STATES ",Pete Buttigieg,DM1,"Town of Plattsburgh 6 ",0,0,0,1,1,0.56
"PRESIDENT OF THE UNITED STATES ",Pete Buttigieg,DM1,"Town of Plattsburgh 7 ",0,2,0,2,4,6.06
"PRESIDENT OF THE UNITED STATES ",Pete Buttigieg,DM1,"Town of Saranac 1 ",0,1,0,1,2,2.33
"PRESIDENT OF THE UNITED STATES ",Pete Buttigieg,DM1,"Town of Saranac 2 ",0,0,0,0,0,0.00
"PRESIDENT OF THE UNITED STATES ",Pete Buttigieg,DM1,"Town of Saranac 3 ",0,0,0,0,0,0.00
"PRESIDENT OF THE UNITED STATES ",Pete Buttigieg,DM1,"Town of Schuyler Falls 1 ",0,1,0,0,1,3.13
"PRESIDENT OF THE UNITED STATES ",Pete Buttigieg,DM1,"Town of Schuyler Falls 2 ",0,2,0,2,4,4.26
"PRESIDENT OF THE UNITED STATES ",Pete Buttigieg,DM1,"Town of Schuyler Falls 3 ",0,2,0,0,2,2.67
"PRESIDENT OF THE UNITED STATES ",Amy Klobuchar,DM2,"City of Plattsburgh Ward 1 1 ",0,0,0,0,0,0.00
"PRESIDENT OF THE UNITED STATES ",Amy Klobuchar,DM2,"City of Plattsburgh Ward 1 2 ",0,3,0,1,4,1.50
"PRESIDENT OF THE UNITED STATES ",Amy Klobuchar,DM2,"City of Plattsburgh Ward 1 3 ",0,0,0,0,0,0.00
"PRESIDENT OF THE UNITED STATES ",Amy Klobuchar,DM2,"City of Plattsburgh Ward 2 1 ",0,0,0,1,1,1.10
"PRESIDENT OF THE UNITED STATES ",Amy Klobuchar,DM2,"City of Plattsburgh Ward 2 2 ",0,0,0,0,0,0.00
"PRESIDENT OF THE UNITED STATES ",Amy Klobuchar,DM2,"City of Plattsburgh Ward 3 1 ",0,1,0,0,1,0.73
"PRESIDENT OF THE UNITED STATES ",Amy Klobuchar,DM2,"City of Plattsburgh Ward 3 2 ",0,0,0,0,0,0.00
"PRESIDENT OF THE UNITED STATES ",Amy Klobuchar,DM2,"City of Plattsburgh Ward 4 1 ",0,0,0,1,1,0.57
"PRESIDENT OF THE UNITED STATES ",Amy Klobuchar,DM2,"City of Plattsburgh Ward 4 2 ",0,2,0,0,2,1.14
"PRESIDENT OF THE UNITED STATES ",Amy Klobuchar,DM2,"City of Plattsburgh Ward 5 1 ",0,0,0,0,0,0.00
"PRESIDENT OF THE UNITED STATES ",Amy Klobuchar,DM2,"City of Plattsburgh Ward 5 2 ",0,1,0,0,1,0.58
"PRESIDENT OF THE UNITED STATES ",Amy Klobuchar,DM2,"City of Plattsburgh Ward 6 1 ",0,0,0,0,0,0.00
"PRESIDENT OF THE UNITED STATES ",Amy Klobuchar,DM2,"City of Plattsburgh Ward 6 2 ",0,0,0,0,0,0.00
"PRESIDENT OF THE UNITED STATES ",Amy Klobuchar,DM2,"Town of Altona 1 ",0,0,0,0,0,0.00
"PRESIDENT OF THE UNITED STATES ",Amy Klobuchar,DM2,"Town of AuSable 1 ",0,0,0,0,0,0.00
"PRESIDENT OF THE UNITED STATES ",Amy Klobuchar,DM2,"Town of AuSable 2 ",0,0,0,0,0,0.00
"PRESIDENT OF THE UNITED STATES ",Amy Klobuchar,DM2,"Town of Beekmantown 1 ",0,0,0,0,0,0.00
"PRESIDENT OF THE UNITED STATES ",Amy Klobuchar,DM2,"Town of Beekmantown 2 ",0,0,0,0,0,0.00
"PRESIDENT OF THE UNITED STATES ",Amy Klobuchar,DM2,"Town of Beekmantown 3 ",0,0,0,0,0,0.00
"PRESIDENT OF THE UNITED STATES ",Amy Klobuchar,DM2,"Town of Beekmantown 4 ",0,0,0,0,0,0.00
"PRESIDENT OF THE UNITED STATES ",Amy Klobuchar,DM2,"Town of Black Brook 1 ",0,0,0,0,0,0.00
"PRESIDENT OF THE UNITED STATES ",Amy Klobuchar,DM2,"Town of Black Brook 2 ",0,1,0,0,1,5.26
"PRESIDENT OF THE UNITED STATES ",Amy Klobuchar,DM2,"Town of Champlain 1 ",0,0,0,0,0,0.00
"PRESIDENT OF THE UNITED STATES ",Amy Klobuchar,DM2,"Town of Champlain 2 ",0,0,0,0,0,0.00
"PRESIDENT OF THE UNITED STATES ",Amy Klobuchar,DM2,"Town of Champlain 3 ",0,1,0,0,1,1.19
"PRESIDENT OF THE UNITED STATES ",Amy Klobuchar,DM2,"Town of Chazy 1 ",0,0,0,0,0,0.00
"PRESIDENT OF THE UNITED STATES ",Amy Klobuchar,DM2,"Town of Chazy 2 ",0,1,0,0,1,1.09
"PRESIDENT OF THE UNITED STATES ",Amy Klobuchar,DM2,"Town of Clinton 1 ",0,2,0,0,2,7.41
"PRESIDENT OF THE UNITED STATES ",Amy Klobuchar,DM2,"Town of Dannemora 1 ",0,0,0,0,0,0.00
"PRESIDENT OF THE UNITED STATES ",Amy Klobuchar,DM2,"Town of Dannemora 2 ",0,0,0,0,0,0.00
"PRESIDENT OF THE UNITED STATES ",Amy Klobuchar,DM2,"Town of Dannemora 3 ",0,0,0,1,1,2.56
"PRESIDENT OF THE UNITED STATES ",Amy Klobuchar,DM2,"Town of Ellenburg 1 ",0,0,0,0,0,0.00
"PRESIDENT OF THE UNITED STATES ",Amy Klobuchar,DM2,"Town of Mooers 1 ",0,1,0,0,1,1.49
"PRESIDENT OF THE UNITED STATES ",Amy Klobuchar,DM2,"Town of Mooers 2 ",0,0,0,0,0,0.00
"PRESIDENT OF THE UNITED STATES ",Amy Klobuchar,DM2,"Town of Peru 1 ",0,0,0,0,0,0.00
"PRESIDENT OF THE UNITED STATES ",Amy Klobuchar,DM2,"Town of Peru 2 ",0,1,0,2,3,2.68
"PRESIDENT OF THE UNITED STATES ",Amy Klobuchar,DM2,"Town of Peru 3 ",0,0,0,0,0,0.00
"PRESIDENT OF THE UNITED STATES ",Amy Klobuchar,DM2,"Town of Peru 4 ",0,2,0,0,2,1.85
"PRESIDENT OF THE UNITED STATES ",Amy Klobuchar,DM2,"Town of Plattsburgh 1 ",0,0,0,0,0,0.00
"PRESIDENT OF THE UNITED STATES ",Amy Klobuchar,DM2,"Town of Plattsburgh 2 ",0,0,0,0,0,0.00
"PRESIDENT OF THE UNITED STATES ",Amy Klobuchar,DM2,"Town of Plattsburgh 3 ",0,0,0,0,0,0.00
"PRESIDENT OF THE UNITED STATES ",Amy Klobuchar,DM2,"Town of Plattsburgh 4 ",0,1,0,0,1,1.20
"PRESIDENT OF THE UNITED STATES ",Amy Klobuchar,DM2,"Town of Plattsburgh 5 ",0,0,0,0,0,0.00
"PRESIDENT OF THE UNITED STATES ",Amy Klobuchar,DM2,"Town of Plattsburgh 6 ",0,0,0,0,0,0.00
"PRESIDENT OF THE UNITED STATES ",Amy Klobuchar,DM2,"Town of Plattsburgh 7 ",0,1,0,1,2,3.03
"PRESIDENT OF THE UNITED STATES ",Amy Klobuchar,DM2,"Town of Saranac 1 ",0,0,0,0,0,0.00
"PRESIDENT OF THE UNITED STATES ",Amy Klobuchar,DM2,"Town of Saranac 2 ",0,1,0,0,1,2.08
"PRESIDENT OF THE UNITED STATES ",Amy Klobuchar,DM2,"Town of Saranac 3 ",0,0,0,0,0,0.00
"PRESIDENT OF THE UNITED STATES ",Amy Klobuchar,DM2,"Town of Schuyler Falls 1 ",0,0,0,0,0,0.00
"PRESIDENT OF THE UNITED STATES ",Amy Klobuchar,DM2,"Town of Schuyler Falls 2 ",0,1,0,0,1,1.06
"PRESIDENT OF THE UNITED STATES ",Amy Klobuchar,DM2,"Town of Schuyler Falls 3 ",0,0,0,0,0,0.00
"PRESIDENT OF THE UNITED STATES ",Joseph R. Biden,DM3,"City of Plattsburgh Ward 1 1 ",0,29,0,5,34,69.39
"PRESIDENT OF THE UNITED STATES ",Joseph R. Biden,DM3,"City of Plattsburgh Ward 1 2 ",0,142,0,53,195,73.31
"PRESIDENT OF THE UNITED STATES ",Joseph R. Biden,DM3,"City of Plattsburgh Ward 1 3 ",0,2,0,1,3,42.86
"PRESIDENT OF THE UNITED STATES ",Joseph R. Biden,DM3,"City of Plattsburgh Ward 2 1 ",0,40,0,19,59,64.84
"PRESIDENT OF THE UNITED STATES ",Joseph R. Biden,DM3,"City of Plattsburgh Ward 2 2 ",0,15,0,8,23,46.94
"PRESIDENT OF THE UNITED STATES ",Joseph R. Biden,DM3,"City of Plattsburgh Ward 3 1 ",0,70,0,29,99,72.26
"PRESIDENT OF THE UNITED STATES ",Joseph R. Biden,DM3,"City of Plattsburgh Ward 3 2 ",0,76,0,49,125,68.31
"PRESIDENT OF THE UNITED STATES ",Joseph R. Biden,DM3,"City of Plattsburgh Ward 4 1 ",0,69,0,40,109,62.29
"PRESIDENT OF THE UNITED STATES ",Joseph R. Biden,DM3,"City of Plattsburgh Ward 4 2 ",0,87,0,42,129,73.71
"PRESIDENT OF THE UNITED STATES ",Joseph R. Biden,DM3,"City of Plattsburgh Ward 5 1 ",0,49,0,22,71,62.83
"PRESIDENT OF THE UNITED STATES ",Joseph R. Biden,DM3,"City of Plattsburgh Ward 5 2 ",0,76,0,31,107,61.85
"PRESIDENT OF THE UNITED STATES ",Joseph R. Biden,DM3,"City of Plattsburgh Ward 6 1 ",0,59,0,27,86,60.99
"PRESIDENT OF THE UNITED STATES ",Joseph R. Biden,DM3,"City of Plattsburgh Ward 6 2 ",0,21,0,22,43,50.59
"PRESIDENT OF THE UNITED STATES ",Joseph R. Biden,DM3,"Town of Altona 1 ",0,37,0,19,56,68.29
"PRESIDENT OF THE UNITED STATES ",Joseph R. Biden,DM3,"Town of AuSable 1 ",0,12,0,18,30,57.69
"PRESIDENT OF THE UNITED STATES ",Joseph R. Biden,DM3,"Town of AuSable 2 ",0,34,0,15,49,76.56
"PRESIDENT OF THE UNITED STATES ",Joseph R. Biden,DM3,"Town of Beekmantown 1 ",0,30,0,17,47,72.31
"PRESIDENT OF THE UNITED STATES ",Joseph R. Biden,DM3,"Town of Beekmantown 2 ",0,32,0,13,45,81.82
"PRESIDENT OF THE UNITED STATES ",Joseph R. Biden,DM3,"Town of Beekmantown 3 ",0,79,0,22,101,73.72
"PRESIDENT OF THE UNITED STATES ",Joseph R. Biden,DM3,"Town of Beekmantown 4 ",0,42,0,14,56,76.71
"PRESIDENT OF THE UNITED STATES ",Joseph R. Biden,DM3,"Town of Black Brook 1 ",0,28,0,11,39,79.59
"PRESIDENT OF THE UNITED STATES ",Joseph R. Biden,DM3,"Town of Black Brook 2 ",0,6,0,5,11,57.89
"PRESIDENT OF THE UNITED STATES ",Joseph R. Biden,DM3,"Town of Champlain 1 ",0,53,0,13,66,80.49
"PRESIDENT OF THE UNITED STATES ",Joseph R. Biden,DM3,"Town of Champlain 2 ",0,61,0,18,79,75.24
"PRESIDENT OF THE UNITED STATES ",Joseph R. Biden,DM3,"Town of Champlain 3 ",0,45,0,7,52,61.90
"PRESIDENT OF THE UNITED STATES ",Joseph R. Biden,DM3,"Town of Chazy 1 ",0,61,0,18,79,75.24
"PRESIDENT OF THE UNITED STATES ",Joseph R. Biden,DM3,"Town of Chazy 2 ",0,46,0,12,58,63.04
"PRESIDENT OF THE UNITED STATES ",Joseph R. Biden,DM3,"Town of Clinton 1 ",0,15,0,5,20,74.07
"PRESIDENT OF THE UNITED STATES ",Joseph R. Biden,DM3,"Town of Dannemora 1 ",0,5,0,9,14,87.50
"PRESIDENT OF THE UNITED STATES ",Joseph R. Biden,DM3,"Town of Dannemora 2 ",0,12,0,5,17,68.00
"PRESIDENT OF THE UNITED STATES ",Joseph R. Biden,DM3,"Town of Dannemora 3 ",0,17,0,12,29,74.36
"PRESIDENT OF THE UNITED STATES ",Joseph R. Biden,DM3,"Town of Ellenburg 1 ",0,47,0,12,59,79.73
"PRESIDENT OF THE UNITED STATES ",Joseph R. Biden,DM3,"Town of Mooers 1 ",0,35,0,17,52,77.61
"PRESIDENT OF THE UNITED STATES ",Joseph R. Biden,DM3,"Town of Mooers 2 ",0,22,0,0,22,70.97
"PRESIDENT OF THE UNITED STATES ",Joseph R. Biden,DM3,"Town of Peru 1 ",0,48,0,10,58,78.38
"PRESIDENT OF THE UNITED STATES ",Joseph R. Biden,DM3,"Town of Peru 2 ",0,59,0,20,79,70.54
"PRESIDENT OF THE UNITED STATES ",Joseph R. Biden,DM3,"Town of Peru 3 ",0,21,0,4,25,73.53
"PRESIDENT OF THE UNITED STATES ",Joseph R. Biden,DM3,"Town of Peru 4 ",0,66,0,14,80,74.07
"PRESIDENT OF THE UNITED STATES ",Joseph R. Biden,DM3,"Town of Plattsburgh 1 ",0,37,0,10,47,61.04
"PRESIDENT OF THE UNITED STATES ",Joseph R. Biden,DM3,"Town of Plattsburgh 2 ",0,57,0,16,73,76.04
"PRESIDENT OF THE UNITED STATES ",Joseph R. Biden,DM3,"Town of Plattsburgh 3 ",0,58,0,35,93,76.86
"PRESIDENT OF THE UNITED STATES ",Joseph R. Biden,DM3,"Town of Plattsburgh 4 ",0,44,0,10,54,65.06
"PRESIDENT OF THE UNITED STATES ",Joseph R. Biden,DM3,"Town of Plattsburgh 5 ",0,28,0,13,41,67.21
"PRESIDENT OF THE UNITED STATES ",Joseph R. Biden,DM3,"Town of Plattsburgh 6 ",0,94,0,35,129,72.07
"PRESIDENT OF THE UNITED STATES ",Joseph R. Biden,DM3,"Town of Plattsburgh 7 ",0,35,0,3,38,57.58
"PRESIDENT OF THE UNITED STATES ",Joseph R. Biden,DM3,"Town of Saranac 1 ",0,45,0,11,56,65.12
"PRESIDENT OF THE UNITED STATES ",Joseph R. Biden,DM3,"Town of Saranac 2 ",0,22,0,10,32,66.67
"PRESIDENT OF THE UNITED STATES ",Joseph R. Biden,DM3,"Town of Saranac 3 ",0,21,0,11,32,78.05
"PRESIDENT OF THE UNITED STATES ",Joseph R. Biden,DM3,"Town of Schuyler Falls 1 ",0,20,0,4,24,75.00
"PRESIDENT OF THE UNITED STATES ",Joseph R. Biden,DM3,"Town of Schuyler Falls 2 ",0,49,0,15,64,68.09
"PRESIDENT OF THE UNITED STATES ",Joseph R. Biden,DM3,"Town of Schuyler Falls 3 ",0,48,0,6,54,72.00
"PRESIDENT OF THE UNITED STATES ",Tulsi Gabbard,DM4,"City of Plattsburgh Ward 1 1 ",0,0,0,1,1,2.04
"PRESIDENT OF THE UNITED STATES ",Tulsi Gabbard,DM4,"City of Plattsburgh Ward 1 2 ",0,0,0,1,1,0.38
"PRESIDENT OF THE UNITED STATES ",Tulsi Gabbard,DM4,"City of Plattsburgh Ward 1 3 ",0,1,0,0,1,14.29
"PRESIDENT OF THE UNITED STATES ",Tulsi Gabbard,DM4,"City of Plattsburgh Ward 2 1 ",0,0,0,0,0,0.00
"PRESIDENT OF THE UNITED STATES ",Tulsi Gabbard,DM4,"City of Plattsburgh Ward 2 2 ",0,0,0,0,0,0.00
"PRESIDENT OF THE UNITED STATES ",Tulsi Gabbard,DM4,"City of Plattsburgh Ward 3 1 ",0,1,0,0,1,0.73
"PRESIDENT OF THE UNITED STATES ",Tulsi Gabbard,DM4,"City of Plattsburgh Ward 3 2 ",0,0,0,1,1,0.55
"PRESIDENT OF THE UNITED STATES ",Tulsi Gabbard,DM4,"City of Plattsburgh Ward 4 1 ",0,0,0,0,0,0.00
"PRESIDENT OF THE UNITED STATES ",Tulsi Gabbard,DM4,"City of Plattsburgh Ward 4 2 ",0,0,0,0,0,0.00
"PRESIDENT OF THE UNITED STATES ",Tulsi Gabbard,DM4,"City of Plattsburgh Ward 5 1 ",0,0,0,1,1,0.88
"PRESIDENT OF THE UNITED STATES ",Tulsi Gabbard,DM4,"City of Plattsburgh Ward 5 2 ",0,0,0,0,0,0.00
"PRESIDENT OF THE UNITED STATES ",Tulsi Gabbard,DM4,"City of Plattsburgh Ward 6 1 ",0,0,0,0,0,0.00
"PRESIDENT OF THE UNITED STATES ",Tulsi Gabbard,DM4,"City of Plattsburgh Ward 6 2 ",0,1,0,0,1,1.18
"PRESIDENT OF THE UNITED STATES ",Tulsi Gabbard,DM4,"Town of Altona 1 ",0,0,0,0,0,0.00
"PRESIDENT OF THE UNITED STATES ",Tulsi Gabbard,DM4,"Town of AuSable 1 ",0,0,0,0,0,0.00
"PRESIDENT OF THE UNITED STATES ",Tulsi Gabbard,DM4,"Town of AuSable 2 ",0,0,0,0,0,0.00
"PRESIDENT OF THE UNITED STATES ",Tulsi Gabbard,DM4,"Town of Beekmantown 1 ",0,0,0,0,0,0.00
"PRESIDENT OF THE UNITED STATES ",Tulsi Gabbard,DM4,"Town of Beekmantown 2 ",0,0,0,0,0,0.00
"PRESIDENT OF THE UNITED STATES ",Tulsi Gabbard,DM4,"Town of Beekmantown 3 ",0,0,0,2,2,1.46
"PRESIDENT OF THE UNITED STATES ",Tulsi Gabbard,DM4,"Town of Beekmantown 4 ",0,0,0,0,0,0.00
"PRESIDENT OF THE UNITED STATES ",Tulsi Gabbard,DM4,"Town of Black Brook 1 ",0,0,0,1,1,2.04
"PRESIDENT OF THE UNITED STATES ",Tulsi Gabbard,DM4,"Town of Black Brook 2 ",0,0,0,0,0,0.00
"PRESIDENT OF THE UNITED STATES ",Tulsi Gabbard,DM4,"Town of Champlain 1 ",0,1,0,0,1,1.22
"PRESIDENT OF THE UNITED STATES ",Tulsi Gabbard,DM4,"Town of Champlain 2 ",0,0,0,0,0,0.00
"PRESIDENT OF THE UNITED STATES ",Tulsi Gabbard,DM4,"Town of Champlain 3 ",0,0,0,0,0,0.00
"PRESIDENT OF THE UNITED STATES ",Tulsi Gabbard,DM4,"Town of Chazy 1 ",0,0,0,0,0,0.00
"PRESIDENT OF THE UNITED STATES ",Tulsi Gabbard,DM4,"Town of Chazy 2 ",0,0,0,1,1,1.09
"PRESIDENT OF THE UNITED STATES ",Tulsi Gabbard,DM4,"Town of Clinton 1 ",0,0,0,0,0,0.00
"PRESIDENT OF THE UNITED STATES ",Tulsi Gabbard,DM4,"Town of Dannemora 1 ",0,0,0,0,0,0.00
"PRESIDENT OF THE UNITED STATES ",Tulsi Gabbard,DM4,"Town of Dannemora 2 ",0,1,0,0,1,4.00
"PRESIDENT OF THE UNITED STATES ",Tulsi Gabbard,DM4,"Town of Dannemora 3 ",0,0,0,0,0,0.00
"PRESIDENT OF THE UNITED STATES ",Tulsi Gabbard,DM4,"Town of Ellenburg 1 ",0,0,0,1,1,1.35
"PRESIDENT OF THE UNITED STATES ",Tulsi Gabbard,DM4,"Town of Mooers 1 ",0,0,0,0,0,0.00
"PRESIDENT OF THE UNITED STATES ",Tulsi Gabbard,DM4,"Town of Mooers 2 ",0,0,0,0,0,0.00
"PRESIDENT OF THE UNITED STATES ",Tulsi Gabbard,DM4,"Town of Peru 1 ",0,0,0,0,0,0.00
"PRESIDENT OF THE UNITED STATES ",Tulsi Gabbard,DM4,"Town of Peru 2 ",0,0,0,0,0,0.00
"PRESIDENT OF THE UNITED STATES ",Tulsi Gabbard,DM4,"Town of Peru 3 ",0,0,0,0,0,0.00
"PRESIDENT OF THE UNITED STATES ",Tulsi Gabbard,DM4,"Town of Peru 4 ",0,0,0,0,0,0.00
"PRESIDENT OF THE UNITED STATES ",Tulsi Gabbard,DM4,"Town of Plattsburgh 1 ",0,0,0,0,0,0.00
"PRESIDENT OF THE UNITED STATES ",Tulsi Gabbard,DM4,"Town of Plattsburgh 2 ",0,0,0,0,0,0.00
"PRESIDENT OF THE UNITED STATES ",Tulsi Gabbard,DM4,"Town of Plattsburgh 3 ",0,1,0,2,3,2.48
"PRESIDENT OF THE UNITED STATES ",Tulsi Gabbard,DM4,"Town of Plattsburgh 4 ",0,1,0,0,1,1.20
"PRESIDENT OF THE UNITED STATES ",Tulsi Gabbard,DM4,"Town of Plattsburgh 5 ",0,0,0,0,0,0.00
"PRESIDENT OF THE UNITED STATES ",Tulsi Gabbard,DM4,"Town of Plattsburgh 6 ",0,2,0,0,2,1.12
"PRESIDENT OF THE UNITED STATES ",Tulsi Gabbard,DM4,"Town of Plattsburgh 7 ",0,1,0,0,1,1.52
"PRESIDENT OF THE UNITED STATES ",Tulsi Gabbard,DM4,"Town of Saranac 1 ",0,0,0,2,2,2.33
"PRESIDENT OF THE UNITED STATES ",Tulsi Gabbard,DM4,"Town of Saranac 2 ",0,0,0,0,0,0.00
"PRESIDENT OF THE UNITED STATES ",Tulsi Gabbard,DM4,"Town of Saranac 3 ",0,0,0,1,1,2.44
"PRESIDENT OF THE UNITED STATES ",Tulsi Gabbard,DM4,"Town of Schuyler Falls 1 ",0,0,0,0,0,0.00
"PRESIDENT OF THE UNITED STATES ",Tulsi Gabbard,DM4,"Town of Schuyler Falls 2 ",0,1,0,1,2,2.13
"PRESIDENT OF THE UNITED STATES ",Tulsi Gabbard,DM4,"Town of Schuyler Falls 3 ",0,0,0,0,0,0.00
"PRESIDENT OF THE UNITED STATES ",Bernie Sanders,DM5,"City of Plattsburgh Ward 1 1 ",0,5,0,5,10,20.41
"PRESIDENT OF THE UNITED STATES ",Bernie Sanders,DM5,"City of Plattsburgh Ward 1 2 ",0,22,0,25,47,17.67
"PRESIDENT OF THE UNITED STATES ",Bernie Sanders,DM5,"City of Plattsburgh Ward 1 3 ",0,2,0,0,2,28.57
"PRESIDENT OF THE UNITED STATES ",Bernie Sanders,DM5,"City of Plattsburgh Ward 2 1 ",0,8,0,17,25,27.47
"PRESIDENT OF THE UNITED STATES ",Bernie Sanders,DM5,"City of Plattsburgh Ward 2 2 ",0,5,0,12,17,34.69
"PRESIDENT OF THE UNITED STATES ",Bernie Sanders,DM5,"City of Plattsburgh Ward 3 1 ",0,15,0,9,24,17.52
"PRESIDENT OF THE UNITED STATES ",Bernie Sanders,DM5,"City of Plattsburgh Ward 3 2 ",0,29,0,14,43,23.50
"PRESIDENT OF THE UNITED STATES ",Bernie Sanders,DM5,"City of Plattsburgh Ward 4 1 ",0,23,0,31,54,30.86
"PRESIDENT OF THE UNITED STATES ",Bernie Sanders,DM5,"City of Plattsburgh Ward 4 2 ",0,18,0,11,29,16.57
"PRESIDENT OF THE UNITED STATES ",Bernie Sanders,DM5,"City of Plattsburgh Ward 5 1 ",0,16,0,13,29,25.66
"PRESIDENT OF THE UNITED STATES ",Bernie Sanders,DM5,"City of Plattsburgh Ward 5 2 ",0,26,0,23,49,28.32
"PRESIDENT OF THE UNITED STATES ",Bernie Sanders,DM5,"City of Plattsburgh Ward 6 1 ",0,24,0,23,47,33.33
"PRESIDENT OF THE UNITED STATES ",Bernie Sanders,DM5,"City of Plattsburgh Ward 6 2 ",0,16,0,22,38,44.71
"PRESIDENT OF THE UNITED STATES ",Bernie Sanders,DM5,"Town of Altona 1 ",0,17,0,1,18,21.95
"PRESIDENT OF THE UNITED STATES ",Bernie Sanders,DM5,"Town of AuSable 1 ",0,8,0,6,14,26.92
"PRESIDENT OF THE UNITED STATES ",Bernie Sanders,DM5,"Town of AuSable 2 ",0,8,0,2,10,15.63
"PRESIDENT OF THE UNITED STATES ",Bernie Sanders,DM5,"Town of Beekmantown 1 ",0,8,0,4,12,18.46
"PRESIDENT OF THE UNITED STATES ",Bernie Sanders,DM5,"Town of Beekmantown 2 ",0,5,0,4,9,16.36
"PRESIDENT OF THE UNITED STATES ",Bernie Sanders,DM5,"Town of Beekmantown 3 ",0,15,0,12,27,19.71
"PRESIDENT OF THE UNITED STATES ",Bernie Sanders,DM5,"Town of Beekmantown 4 ",0,9,0,5,14,19.18
"PRESIDENT OF THE UNITED STATES ",Bernie Sanders,DM5,"Town of Black Brook 1 ",0,3,0,1,4,8.16
"PRESIDENT OF THE UNITED STATES ",Bernie Sanders,DM5,"Town of Black Brook 2 ",0,3,0,2,5,26.32
"PRESIDENT OF THE UNITED STATES ",Bernie Sanders,DM5,"Town of Champlain 1 ",0,8,0,3,11,13.41
"PRESIDENT OF THE UNITED STATES ",Bernie Sanders,DM5,"Town of Champlain 2 ",0,13,0,6,19,18.10
"PRESIDENT OF THE UNITED STATES ",Bernie Sanders,DM5,"Town of Champlain 3 ",0,10,0,15,25,29.76
"PRESIDENT OF THE UNITED STATES ",Bernie Sanders,DM5,"Town of Chazy 1 ",0,16,0,4,20,19.05
"PRESIDENT OF THE UNITED STATES ",Bernie Sanders,DM5,"Town of Chazy 2 ",0,21,0,5,26,28.26
"PRESIDENT OF THE UNITED STATES ",Bernie Sanders,DM5,"Town of Clinton 1 ",0,1,0,1,2,7.41
"PRESIDENT OF THE UNITED STATES ",Bernie Sanders,DM5,"Town of Dannemora 1 ",0,0,0,0,0,0.00
"PRESIDENT OF THE UNITED STATES ",Bernie Sanders,DM5,"Town of Dannemora 2 ",0,1,0,5,6,24.00
"PRESIDENT OF THE UNITED STATES ",Bernie Sanders,DM5,"Town of Dannemora 3 ",0,1,0,4,5,12.82
"PRESIDENT OF THE UNITED STATES ",Bernie Sanders,DM5,"Town of Ellenburg 1 ",0,5,0,1,6,8.11
"PRESIDENT OF THE UNITED STATES ",Bernie Sanders,DM5,"Town of Mooers 1 ",0,5,0,5,10,14.93
"PRESIDENT OF THE UNITED STATES ",Bernie Sanders,DM5,"Town of Mooers 2 ",0,2,0,6,8,25.81
"PRESIDENT OF THE UNITED STATES ",Bernie Sanders,DM5,"Town of Peru 1 ",0,6,0,5,11,14.86
"PRESIDENT OF THE UNITED STATES ",Bernie Sanders,DM5,"Town of Peru 2 ",0,19,0,8,27,24.11
"PRESIDENT OF THE UNITED STATES ",Bernie Sanders,DM5,"Town of Peru 3 ",0,7,0,1,8,23.53
"PRESIDENT OF THE UNITED STATES ",Bernie Sanders,DM5,"Town of Peru 4 ",0,15,0,8,23,21.30
"PRESIDENT OF THE UNITED STATES ",Bernie Sanders,DM5,"Town of Plattsburgh 1 ",0,16,0,5,21,27.27
"PRESIDENT OF THE UNITED STATES ",Bernie Sanders,DM5,"Town of Plattsburgh 2 ",0,15,0,7,22,22.92
"PRESIDENT OF THE UNITED STATES ",Bernie Sanders,DM5,"Town of Plattsburgh 3 ",0,13,0,8,21,17.36
"PRESIDENT OF THE UNITED STATES ",Bernie Sanders,DM5,"Town of Plattsburgh 4 ",0,6,0,9,15,18.07
"PRESIDENT OF THE UNITED STATES ",Bernie Sanders,DM5,"Town of Plattsburgh 5 ",0,12,0,5,17,27.87
"PRESIDENT OF THE UNITED STATES ",Bernie Sanders,DM5,"Town of Plattsburgh 6 ",0,20,0,15,35,19.55
"PRESIDENT OF THE UNITED STATES ",Bernie Sanders,DM5,"Town of Plattsburgh 7 ",0,10,0,9,19,28.79
"PRESIDENT OF THE UNITED STATES ",Bernie Sanders,DM5,"Town of Saranac 1 ",0,11,0,4,15,17.44
"PRESIDENT OF THE UNITED STATES ",Bernie Sanders,DM5,"Town of Saranac 2 ",0,5,0,7,12,25.00
"PRESIDENT OF THE UNITED STATES ",Bernie Sanders,DM5,"Town of Saranac 3 ",0,3,0,3,6,14.63
"PRESIDENT OF THE UNITED STATES ",Bernie Sanders,DM5,"Town of Schuyler Falls 1 ",0,3,0,4,7,21.88
"PRESIDENT OF THE UNITED STATES ",Bernie Sanders,DM5,"Town of Schuyler Falls 2 ",0,14,0,5,19,20.21
"PRESIDENT OF THE UNITED STATES ",Bernie Sanders,DM5,"Town of Schuyler Falls 3 ",0,5,0,9,14,18.67
"PRESIDENT OF THE UNITED STATES ",Michael R. Bloomberg,DM6,"City of Plattsburgh Ward 1 1 ",0,1,0,0,1,2.04
"PRESIDENT OF THE UNITED STATES ",Michael R. Bloomberg,DM6,"City of Plattsburgh Ward 1 2 ",0,0,0,0,0,0.00
"PRESIDENT OF THE UNITED STATES ",Michael R. Bloomberg,DM6,"City of Plattsburgh Ward 1 3 ",0,0,0,0,0,0.00
"PRESIDENT OF THE UNITED STATES ",Michael R. Bloomberg,DM6,"City of Plattsburgh Ward 2 1 ",0,0,0,1,1,1.10
"PRESIDENT OF THE UNITED STATES ",Michael R. Bloomberg,DM6,"City of Plattsburgh Ward 2 2 ",0,0,0,1,1,2.04
"PRESIDENT OF THE UNITED STATES ",Michael R. Bloomberg,DM6,"City of Plattsburgh Ward 3 1 ",0,0,0,0,0,0.00
"PRESIDENT OF THE UNITED STATES ",Michael R. Bloomberg,DM6,"City of Plattsburgh Ward 3 2 ",0,0,0,2,2,1.09
"PRESIDENT OF THE UNITED STATES ",Michael R. Bloomberg,DM6,"City of Plattsburgh Ward 4 1 ",0,1,0,1,2,1.14
"PRESIDENT OF THE UNITED STATES ",Michael R. Bloomberg,DM6,"City of Plattsburgh Ward 4 2 ",0,2,0,0,2,1.14
"PRESIDENT OF THE UNITED STATES ",Michael R. Bloomberg,DM6,"City of Plattsburgh Ward 5 1 ",0,1,0,0,1,0.88
"PRESIDENT OF THE UNITED STATES ",Michael R. Bloomberg,DM6,"City of Plattsburgh Ward 5 2 ",0,3,0,0,3,1.73
"PRESIDENT OF THE UNITED STATES ",Michael R. Bloomberg,DM6,"City of Plattsburgh Ward 6 1 ",0,0,0,0,0,0.00
"PRESIDENT OF THE UNITED STATES ",Michael R. Bloomberg,DM6,"City of Plattsburgh Ward 6 2 ",0,0,0,0,0,0.00
"PRESIDENT OF THE UNITED STATES ",Michael R. Bloomberg,DM6,"Town of Altona 1 ",0,0,0,0,0,0.00
"PRESIDENT OF THE UNITED STATES ",Michael R. Bloomberg,DM6,"Town of AuSable 1 ",0,0,0,0,0,0.00
"PRESIDENT OF THE UNITED STATES ",Michael R. Bloomberg,DM6,"Town of AuSable 2 ",0,0,0,0,0,0.00
"PRESIDENT OF THE UNITED STATES ",Michael R. Bloomberg,DM6,"Town of Beekmantown 1 ",0,1,0,0,1,1.54
"PRESIDENT OF THE UNITED STATES ",Michael R. Bloomberg,DM6,"Town of Beekmantown 2 ",0,0,0,0,0,0.00
"PRESIDENT OF THE UNITED STATES ",Michael R. Bloomberg,DM6,"Town of Beekmantown 3 ",0,0,0,0,0,0.00
"PRESIDENT OF THE UNITED STATES ",Michael R. Bloomberg,DM6,"Town of Beekmantown 4 ",0,0,0,0,0,0.00
"PRESIDENT OF THE UNITED STATES ",Michael R. Bloomberg,DM6,"Town of Black Brook 1 ",0,0,0,0,0,0.00
"PRESIDENT OF THE UNITED STATES ",Michael R. Bloomberg,DM6,"Town of Black Brook 2 ",0,0,0,0,0,0.00
"PRESIDENT OF THE UNITED STATES ",Michael R. Bloomberg,DM6,"Town of Champlain 1 ",0,0,0,1,1,1.22
"PRESIDENT OF THE UNITED STATES ",Michael R. Bloomberg,DM6,"Town of Champlain 2 ",0,0,0,0,0,0.00
"PRESIDENT OF THE UNITED STATES ",Michael R. Bloomberg,DM6,"Town of Champlain 3 ",0,0,0,0,0,0.00
"PRESIDENT OF THE UNITED STATES ",Michael R. Bloomberg,DM6,"Town of Chazy 1 ",0,0,0,0,0,0.00
"PRESIDENT OF THE UNITED STATES ",Michael R. Bloomberg,DM6,"Town of Chazy 2 ",0,0,0,0,0,0.00
"PRESIDENT OF THE UNITED STATES ",Michael R. Bloomberg,DM6,"Town of Clinton 1 ",0,0,0,1,1,3.70
"PRESIDENT OF THE UNITED STATES ",Michael R. Bloomberg,DM6,"Town of Dannemora 1 ",0,0,0,0,0,0.00
"PRESIDENT OF THE UNITED STATES ",Michael R. Bloomberg,DM6,"Town of Dannemora 2 ",0,0,0,0,0,0.00
"PRESIDENT OF THE UNITED STATES ",Michael R. Bloomberg,DM6,"Town of Dannemora 3 ",0,0,0,1,1,2.56
"PRESIDENT OF THE UNITED STATES ",Michael R. Bloomberg,DM6,"Town of Ellenburg 1 ",0,0,0,0,0,0.00
"PRESIDENT OF THE UNITED STATES ",Michael R. Bloomberg,DM6,"Town of Mooers 1 ",0,1,0,0,1,1.49
"PRESIDENT OF THE UNITED STATES ",Michael R. Bloomberg,DM6,"Town of Mooers 2 ",0,0,0,0,0,0.00
"PRESIDENT OF THE UNITED STATES ",Michael R. Bloomberg,DM6,"Town of Peru 1 ",0,0,0,0,0,0.00
"PRESIDENT OF THE UNITED STATES ",Michael R. Bloomberg,DM6,"Town of Peru 2 ",0,0,0,0,0,0.00
"PRESIDENT OF THE UNITED STATES ",Michael R. Bloomberg,DM6,"Town of Peru 3 ",0,0,0,0,0,0.00
"PRESIDENT OF THE UNITED STATES ",Michael R. Bloomberg,DM6,"Town of Peru 4 ",0,0,0,0,0,0.00
"PRESIDENT OF THE UNITED STATES ",Michael R. Bloomberg,DM6,"Town of Plattsburgh 1 ",0,1,0,0,1,1.30
"PRESIDENT OF THE UNITED STATES ",Michael R. Bloomberg,DM6,"Town of Plattsburgh 2 ",0,0,0,0,0,0.00
"PRESIDENT OF THE UNITED STATES ",Michael R. Bloomberg,DM6,"Town of Plattsburgh 3 ",0,1,0,1,2,1.65
"PRESIDENT OF THE UNITED STATES ",Michael R. Bloomberg,DM6,"Town of Plattsburgh 4 ",0,0,0,0,0,0.00
"PRESIDENT OF THE UNITED STATES ",Michael R. Bloomberg,DM6,"Town of Plattsburgh 5 ",0,0,0,2,2,3.28
"PRESIDENT OF THE UNITED STATES ",Michael R. Bloomberg,DM6,"Town of Plattsburgh 6 ",0,0,0,0,0,0.00
"PRESIDENT OF THE UNITED STATES ",Michael R. Bloomberg,DM6,"Town of Plattsburgh 7 ",0,0,0,0,0,0.00
"PRESIDENT OF THE UNITED STATES ",Michael R. Bloomberg,DM6,"Town of Saranac 1 ",0,3,0,1,4,4.65
"PRESIDENT OF THE UNITED STATES ",Michael R. Bloomberg,DM6,"Town of Saranac 2 ",0,0,0,2,2,4.17
"PRESIDENT OF THE UNITED STATES ",Michael R. Bloomberg,DM6,"Town of Saranac 3 ",0,0,0,0,0,0.00
"PRESIDENT OF THE UNITED STATES ",Michael R. Bloomberg,DM6,"Town of Schuyler Falls 1 ",0,0,0,0,0,0.00
"PRESIDENT OF THE UNITED STATES ",Michael R. Bloomberg,DM6,"Town of Schuyler Falls 2 ",0,0,0,0,0,0.00
"PRESIDENT OF THE UNITED STATES ",Michael R. Bloomberg,DM6,"Town of Schuyler Falls 3 ",0,0,0,0,0,0.00
"PRESIDENT OF THE UNITED STATES ",Tom Steyer,DM7,"City of Plattsburgh Ward 1 1 ",0,0,0,0,0,0.00
"PRESIDENT OF THE UNITED STATES ",Tom Steyer,DM7,"City of Plattsburgh Ward 1 2 ",0,0,0,0,0,0.00
"PRESIDENT OF THE UNITED STATES ",Tom Steyer,DM7,"City of Plattsburgh Ward 1 3 ",0,0,0,0,0,0.00
"PRESIDENT OF THE UNITED STATES ",Tom Steyer,DM7,"City of Plattsburgh Ward 2 1 ",0,0,0,0,0,0.00
"PRESIDENT OF THE UNITED STATES ",Tom Steyer,DM7,"City of Plattsburgh Ward 2 2 ",0,0,0,0,0,0.00
"PRESIDENT OF THE UNITED STATES ",Tom Steyer,DM7,"City of Plattsburgh Ward 3 1 ",0,0,0,0,0,0.00
"PRESIDENT OF THE UNITED STATES ",Tom Steyer,DM7,"City of Plattsburgh Ward 3 2 ",0,0,0,0,0,0.00
"PRESIDENT OF THE UNITED STATES ",Tom Steyer,DM7,"City of Plattsburgh Ward 4 1 ",0,0,0,0,0,0.00
"PRESIDENT OF THE UNITED STATES ",Tom Steyer,DM7,"City of Plattsburgh Ward 4 2 ",0,0,0,0,0,0.00
"PRESIDENT OF THE UNITED STATES ",Tom Steyer,DM7,"City of Plattsburgh Ward 5 1 ",0,0,0,0,0,0.00
"PRESIDENT OF THE UNITED STATES ",Tom Steyer,DM7,"City of Plattsburgh Ward 5 2 ",0,1,0,0,1,0.58
"PRESIDENT OF THE UNITED STATES ",Tom Steyer,DM7,"City of Plattsburgh Ward 6 1 ",0,0,0,0,0,0.00
"PRESIDENT OF THE UNITED STATES ",Tom Steyer,DM7,"City of Plattsburgh Ward 6 2 ",0,0,0,0,0,0.00
"PRESIDENT OF THE UNITED STATES ",Tom Steyer,DM7,"Town of Altona 1 ",0,0,0,0,0,0.00
"PRESIDENT OF THE UNITED STATES ",Tom Steyer,DM7,"Town of AuSable 1 ",0,0,0,1,1,1.92
"PRESIDENT OF THE UNITED STATES ",Tom Steyer,DM7,"Town of AuSable 2 ",0,0,0,0,0,0.00
"PRESIDENT OF THE UNITED STATES ",Tom Steyer,DM7,"Town of Beekmantown 1 ",0,0,0,0,0,0.00
"PRESIDENT OF THE UNITED STATES ",Tom Steyer,DM7,"Town of Beekmantown 2 ",0,0,0,0,0,0.00
"PRESIDENT OF THE UNITED STATES ",Tom Steyer,DM7,"Town of Beekmantown 3 ",0,0,0,0,0,0.00
"PRESIDENT OF THE UNITED STATES ",Tom Steyer,DM7,"Town of Beekmantown 4 ",0,0,0,0,0,0.00
"PRESIDENT OF THE UNITED STATES ",Tom Steyer,DM7,"Town of Black Brook 1 ",0,0,0,0,0,0.00
"PRESIDENT OF THE UNITED STATES ",Tom Steyer,DM7,"Town of Black Brook 2 ",0,0,0,0,0,0.00
"PRESIDENT OF THE UNITED STATES ",Tom Steyer,DM7,"Town of Champlain 1 ",0,0,0,0,0,0.00
"PRESIDENT OF THE UNITED STATES ",Tom Steyer,DM7,"Town of Champlain 2 ",0,0,0,0,0,0.00
"PRESIDENT OF THE UNITED STATES ",Tom Steyer,DM7,"Town of Champlain 3 ",0,0,0,0,0,0.00
"PRESIDENT OF THE UNITED STATES ",Tom Steyer,DM7,"Town of Chazy 1 ",0,0,0,0,0,0.00
"PRESIDENT OF THE UNITED STATES ",Tom Steyer,DM7,"Town of Chazy 2 ",0,0,0,0,0,0.00
"PRESIDENT OF THE UNITED STATES ",Tom Steyer,DM7,"Town of Clinton 1 ",0,0,0,0,0,0.00
"PRESIDENT OF THE UNITED STATES ",Tom Steyer,DM7,"Town of Dannemora 1 ",0,0,0,0,0,0.00
"PRESIDENT OF THE UNITED STATES ",Tom Steyer,DM7,"Town of Dannemora 2 ",0,0,0,0,0,0.00
"PRESIDENT OF THE UNITED STATES ",Tom Steyer,DM7,"Town of Dannemora 3 ",0,0,0,0,0,0.00
"PRESIDENT OF THE UNITED STATES ",Tom Steyer,DM7,"Town of Ellenburg 1 ",0,0,0,0,0,0.00
"PRESIDENT OF THE UNITED STATES ",Tom Steyer,DM7,"Town of Mooers 1 ",0,0,0,0,0,0.00
"PRESIDENT OF THE UNITED STATES ",Tom Steyer,DM7,"Town of Mooers 2 ",0,0,0,0,0,0.00
"PRESIDENT OF THE UNITED STATES ",Tom Steyer,DM7,"Town of Peru 1 ",0,0,0,0,0,0.00
"PRESIDENT OF THE UNITED STATES ",Tom Steyer,DM7,"Town of Peru 2 ",0,0,0,0,0,0.00
"PRESIDENT OF THE UNITED STATES ",Tom Steyer,DM7,"Town of Peru 3 ",0,0,0,0,0,0.00
"PRESIDENT OF THE UNITED STATES ",Tom Steyer,DM7,"Town of Peru 4 ",0,0,0,0,0,0.00
"PRESIDENT OF THE UNITED STATES ",Tom Steyer,DM7,"Town of Plattsburgh 1 ",0,0,0,0,0,0.00
"PRESIDENT OF THE UNITED STATES ",Tom Steyer,DM7,"Town of Plattsburgh 2 ",0,0,0,0,0,0.00
"PRESIDENT OF THE UNITED STATES ",Tom Steyer,DM7,"Town of Plattsburgh 3 ",0,0,0,0,0,0.00
"PRESIDENT OF THE UNITED STATES ",Tom Steyer,DM7,"Town of Plattsburgh 4 ",0,0,0,0,0,0.00
"PRESIDENT OF THE UNITED STATES ",Tom Steyer,DM7,"Town of Plattsburgh 5 ",0,0,0,0,0,0.00
"PRESIDENT OF THE UNITED STATES ",Tom Steyer,DM7,"Town of Plattsburgh 6 ",0,0,0,0,0,0.00
"PRESIDENT OF THE UNITED STATES ",Tom Steyer,DM7,"Town of Plattsburgh 7 ",0,0,0,0,0,0.00
"PRESIDENT OF THE UNITED STATES ",Tom Steyer,DM7,"Town of Saranac 1 ",0,1,0,0,1,1.16
"PRESIDENT OF THE UNITED STATES ",Tom Steyer,DM7,"Town of Saranac 2 ",0,0,0,0,0,0.00
"PRESIDENT OF THE UNITED STATES ",Tom Steyer,DM7,"Town of Saranac 3 ",0,0,0,0,0,0.00
"PRESIDENT OF THE UNITED STATES ",Tom Steyer,DM7,"Town of Schuyler Falls 1 ",0,0,0,0,0,0.00
"PRESIDENT OF THE UNITED STATES ",Tom Steyer,DM7,"Town of Schuyler Falls 2 ",0,0,0,0,0,0.00
"PRESIDENT OF THE UNITED STATES ",Tom Steyer,DM7,"Town of Schuyler Falls 3 ",0,0,0,1,1,1.33
"PRESIDENT OF THE UNITED STATES ",Michael Bennet,DM8,"City of Plattsburgh Ward 1 1 ",0,0,0,0,0,0.00
"PRESIDENT OF THE UNITED STATES ",Michael Bennet,DM8,"City of Plattsburgh Ward 1 2 ",0,0,0,0,0,0.00
"PRESIDENT OF THE UNITED STATES ",Michael Bennet,DM8,"City of Plattsburgh Ward 1 3 ",0,0,0,0,0,0.00
"PRESIDENT OF THE UNITED STATES ",Michael Bennet,DM8,"City of Plattsburgh Ward 2 1 ",0,0,0,0,0,0.00
"PRESIDENT OF THE UNITED STATES ",Michael Bennet,DM8,"City of Plattsburgh Ward 2 2 ",0,0,0,0,0,0.00
"PRESIDENT OF THE UNITED STATES ",Michael Bennet,DM8,"City of Plattsburgh Ward 3 1 ",0,0,0,0,0,0.00
"PRESIDENT OF THE UNITED STATES ",Michael Bennet,DM8,"City of Plattsburgh Ward 3 2 ",0,0,0,0,0,0.00
"PRESIDENT OF THE UNITED STATES ",Michael Bennet,DM8,"City of Plattsburgh Ward 4 1 ",0,0,0,0,0,0.00
"PRESIDENT OF THE UNITED STATES ",Michael Bennet,DM8,"City of Plattsburgh Ward 4 2 ",0,0,0,0,0,0.00
"PRESIDENT OF THE UNITED STATES ",Michael Bennet,DM8,"City of Plattsburgh Ward 5 1 ",0,0,0,0,0,0.00
"PRESIDENT OF THE UNITED STATES ",Michael Bennet,DM8,"City of Plattsburgh Ward 5 2 ",0,1,0,0,1,0.58
"PRESIDENT OF THE UNITED STATES ",Michael Bennet,DM8,"City of Plattsburgh Ward 6 1 ",0,0,0,0,0,0.00
"PRESIDENT OF THE UNITED STATES ",Michael Bennet,DM8,"City of Plattsburgh Ward 6 2 ",0,0,0,0,0,0.00
"PRESIDENT OF THE UNITED STATES ",Michael Bennet,DM8,"Town of Altona 1 ",0,0,0,0,0,0.00
"PRESIDENT OF THE UNITED STATES ",Michael Bennet,DM8,"Town of AuSable 1 ",0,0,0,0,0,0.00
"PRESIDENT OF THE UNITED STATES ",Michael Bennet,DM8,"Town of AuSable 2 ",0,0,0,0,0,0.00
"PRESIDENT OF THE UNITED STATES ",Michael Bennet,DM8,"Town of Beekmantown 1 ",0,0,0,0,0,0.00
"PRESIDENT OF THE UNITED STATES ",Michael Bennet,DM8,"Town of Beekmantown 2 ",0,0,0,0,0,0.00
"PRESIDENT OF THE UNITED STATES ",Michael Bennet,DM8,"Town of Beekmantown 3 ",0,1,0,0,1,0.73
"PRESIDENT OF THE UNITED STATES ",Michael Bennet,DM8,"Town of Beekmantown 4 ",0,0,0,0,0,0.00
"PRESIDENT OF THE UNITED STATES ",Michael Bennet,DM8,"Town of Black Brook 1 ",0,0,0,0,0,0.00
"PRESIDENT OF THE UNITED STATES ",Michael Bennet,DM8,"Town of Black Brook 2 ",0,0,0,0,0,0.00
"PRESIDENT OF THE UNITED STATES ",Michael Bennet,DM8,"Town of Champlain 1 ",0,0,0,0,0,0.00
"PRESIDENT OF THE UNITED STATES ",Michael Bennet,DM8,"Town of Champlain 2 ",0,0,0,0,0,0.00
"PRESIDENT OF THE UNITED STATES ",Michael Bennet,DM8,"Town of Champlain 3 ",0,0,0,0,0,0.00
"PRESIDENT OF THE UNITED STATES ",Michael Bennet,DM8,"Town of Chazy 1 ",0,0,0,0,0,0.00
"PRESIDENT OF THE UNITED STATES ",Michael Bennet,DM8,"Town of Chazy 2 ",0,0,0,0,0,0.00
"PRESIDENT OF THE UNITED STATES ",Michael Bennet,DM8,"Town of Clinton 1 ",0,0,0,0,0,0.00
"PRESIDENT OF THE UNITED STATES ",Michael Bennet,DM8,"Town of Dannemora 1 ",0,0,0,0,0,0.00
"PRESIDENT OF THE UNITED STATES ",Michael Bennet,DM8,"Town of Dannemora 2 ",0,0,0,0,0,0.00
"PRESIDENT OF THE UNITED STATES ",Michael Bennet,DM8,"Town of Dannemora 3 ",0,0,0,0,0,0.00
"PRESIDENT OF THE UNITED STATES ",Michael Bennet,DM8,"Town of Ellenburg 1 ",0,0,0,0,0,0.00
"PRESIDENT OF THE UNITED STATES ",Michael Bennet,DM8,"Town of Mooers 1 ",0,0,0,0,0,0.00
"PRESIDENT OF THE UNITED STATES ",Michael Bennet,DM8,"Town of Mooers 2 ",0,0,0,0,0,0.00
"PRESIDENT OF THE UNITED STATES ",Michael Bennet,DM8,"Town of Peru 1 ",0,0,0,0,0,0.00
"PRESIDENT OF THE UNITED STATES ",Michael Bennet,DM8,"Town of Peru 2 ",0,0,0,0,0,0.00
"PRESIDENT OF THE UNITED STATES ",Michael Bennet,DM8,"Town of Peru 3 ",0,0,0,0,0,0.00
"PRESIDENT OF THE UNITED STATES ",Michael Bennet,DM8,"Town of Peru 4 ",0,0,0,0,0,0.00
"PRESIDENT OF THE UNITED STATES ",Michael Bennet,DM8,"Town of Plattsburgh 1 ",0,0,0,0,0,0.00
"PRESIDENT OF THE UNITED STATES ",Michael Bennet,DM8,"Town of Plattsburgh 2 ",0,0,0,0,0,0.00
"PRESIDENT OF THE UNITED STATES ",Michael Bennet,DM8,"Town of Plattsburgh 3 ",0,0,0,0,0,0.00
"PRESIDENT OF THE UNITED STATES ",Michael Bennet,DM8,"Town of Plattsburgh 4 ",0,0,0,0,0,0.00
"PRESIDENT OF THE UNITED STATES ",Michael Bennet,DM8,"Town of Plattsburgh 5 ",0,0,0,0,0,0.00
"PRESIDENT OF THE UNITED STATES ",Michael Bennet,DM8,"Town of Plattsburgh 6 ",0,0,0,2,2,1.12
"PRESIDENT OF THE UNITED STATES ",Michael Bennet,DM8,"Town of Plattsburgh 7 ",0,0,0,0,0,0.00
"PRESIDENT OF THE UNITED STATES ",Michael Bennet,DM8,"Town of Saranac 1 ",0,0,0,0,0,0.00
"PRESIDENT OF THE UNITED STATES ",Michael Bennet,DM8,"Town of Saranac 2 ",0,0,0,0,0,0.00
"PRESIDENT OF THE UNITED STATES ",Michael Bennet,DM8,"Town of Saranac 3 ",0,0,0,0,0,0.00
"PRESIDENT OF THE UNITED STATES ",Michael Bennet,DM8,"Town of Schuyler Falls 1 ",0,0,0,0,0,0.00
"PRESIDENT OF THE UNITED STATES ",Michael Bennet,DM8,"Town of Schuyler Falls 2 ",0,0,0,0,0,0.00
"PRESIDENT OF THE UNITED STATES ",Michael Bennet,DM8,"Town of Schuyler Falls 3 ",0,0,0,0,0,0.00
"PRESIDENT OF THE UNITED STATES ",Elizabeth Warren,DM9,"City of Plattsburgh Ward 1 1 ",0,0,0,0,0,0.00
"PRESIDENT OF THE UNITED STATES ",Elizabeth Warren,DM9,"City of Plattsburgh Ward 1 2 ",0,9,0,3,12,4.51
"PRESIDENT OF THE UNITED STATES ",Elizabeth Warren,DM9,"City of Plattsburgh Ward 1 3 ",0,0,0,0,0,0.00
"PRESIDENT OF THE UNITED STATES ",Elizabeth Warren,DM9,"City of Plattsburgh Ward 2 1 ",0,2,0,1,3,3.30
"PRESIDENT OF THE UNITED STATES ",Elizabeth Warren,DM9,"City of Plattsburgh Ward 2 2 ",0,0,0,1,1,2.04
"PRESIDENT OF THE UNITED STATES ",Elizabeth Warren,DM9,"City of Plattsburgh Ward 3 1 ",0,4,0,2,6,4.38
"PRESIDENT OF THE UNITED STATES ",Elizabeth Warren,DM9,"City of Plattsburgh Ward 3 2 ",0,5,0,1,6,3.28
"PRESIDENT OF THE UNITED STATES ",Elizabeth Warren,DM9,"City of Plattsburgh Ward 4 1 ",0,3,0,2,5,2.86
"PRESIDENT OF THE UNITED STATES ",Elizabeth Warren,DM9,"City of Plattsburgh Ward 4 2 ",0,5,0,1,6,3.43
"PRESIDENT OF THE UNITED STATES ",Elizabeth Warren,DM9,"City of Plattsburgh Ward 5 1 ",0,6,0,1,7,6.19
"PRESIDENT OF THE UNITED STATES ",Elizabeth Warren,DM9,"City of Plattsburgh Ward 5 2 ",0,3,0,3,6,3.47
"PRESIDENT OF THE UNITED STATES ",Elizabeth Warren,DM9,"City of Plattsburgh Ward 6 1 ",0,3,0,3,6,4.26
"PRESIDENT OF THE UNITED STATES ",Elizabeth Warren,DM9,"City of Plattsburgh Ward 6 2 ",0,0,0,1,1,1.18
"PRESIDENT OF THE UNITED STATES ",Elizabeth Warren,DM9,"Town of Altona 1 ",0,2,0,3,5,6.10
"PRESIDENT OF THE UNITED STATES ",Elizabeth Warren,DM9,"Town of AuSable 1 ",0,0,0,0,0,0.00
"PRESIDENT OF THE UNITED STATES ",Elizabeth Warren,DM9,"Town of AuSable 2 ",0,1,0,1,2,3.13
"PRESIDENT OF THE UNITED STATES ",Elizabeth Warren,DM9,"Town of Beekmantown 1 ",0,0,0,3,3,4.62
"PRESIDENT OF THE UNITED STATES ",Elizabeth Warren,DM9,"Town of Beekmantown 2 ",0,0,0,0,0,0.00
"PRESIDENT OF THE UNITED STATES ",Elizabeth Warren,DM9,"Town of Beekmantown 3 ",0,2,0,1,3,2.19
"PRESIDENT OF THE UNITED STATES ",Elizabeth Warren,DM9,"Town of Beekmantown 4 ",0,0,0,1,1,1.37
"PRESIDENT OF THE UNITED STATES ",Elizabeth Warren,DM9,"Town of Black Brook 1 ",0,4,0,0,4,8.16
"PRESIDENT OF THE UNITED STATES ",Elizabeth Warren,DM9,"Town of Black Brook 2 ",0,0,0,0,0,0.00
"PRESIDENT OF THE UNITED STATES ",Elizabeth Warren,DM9,"Town of Champlain 1 ",0,1,0,0,1,1.22
"PRESIDENT OF THE UNITED STATES ",Elizabeth Warren,DM9,"Town of Champlain 2 ",0,2,0,2,4,3.81
"PRESIDENT OF THE UNITED STATES ",Elizabeth Warren,DM9,"Town of Champlain 3 ",0,3,0,0,3,3.57
"PRESIDENT OF THE UNITED STATES ",Elizabeth Warren,DM9,"Town of Chazy 1 ",0,1,0,1,2,1.90
"PRESIDENT OF THE UNITED STATES ",Elizabeth Warren,DM9,"Town of Chazy 2 ",0,0,0,2,2,2.17
"PRESIDENT OF THE UNITED STATES ",Elizabeth Warren,DM9,"Town of Clinton 1 ",0,0,0,1,1,3.70
"PRESIDENT OF THE UNITED STATES ",Elizabeth Warren,DM9,"Town of Dannemora 1 ",0,0,0,0,0,0.00
"PRESIDENT OF THE UNITED STATES ",Elizabeth Warren,DM9,"Town of Dannemora 2 ",0,0,0,0,0,0.00
"PRESIDENT OF THE UNITED STATES ",Elizabeth Warren,DM9,"Town of Dannemora 3 ",0,0,0,1,1,2.56
"PRESIDENT OF THE UNITED STATES ",Elizabeth Warren,DM9,"Town of Ellenburg 1 ",0,1,0,1,2,2.70
"PRESIDENT OF THE UNITED STATES ",Elizabeth Warren,DM9,"Town of Mooers 1 ",0,0,0,0,0,0.00
"PRESIDENT OF THE UNITED STATES ",Elizabeth Warren,DM9,"Town of Mooers 2 ",0,0,0,0,0,0.00
"PRESIDENT OF THE UNITED STATES ",Elizabeth Warren,DM9,"Town of Peru 1 ",0,1,0,0,1,1.35
"PRESIDENT OF THE UNITED STATES ",Elizabeth Warren,DM9,"Town of Peru 2 ",0,1,0,0,1,0.89
"PRESIDENT OF THE UNITED STATES ",Elizabeth Warren,DM9,"Town of Peru 3 ",0,1,0,0,1,2.94
"PRESIDENT OF THE UNITED STATES ",Elizabeth Warren,DM9,"Town of Peru 4 ",0,0,0,2,2,1.85
"PRESIDENT OF THE UNITED STATES ",Elizabeth Warren,DM9,"Town of Plattsburgh 1 ",0,1,0,1,2,2.60
"PRESIDENT OF THE UNITED STATES ",Elizabeth Warren,DM9,"Town of Plattsburgh 2 ",0,0,0,0,0,0.00
"PRESIDENT OF THE UNITED STATES ",Elizabeth Warren,DM9,"Town of Plattsburgh 3 ",0,1,0,0,1,0.83
"PRESIDENT OF THE UNITED STATES ",Elizabeth Warren,DM9,"Town of Plattsburgh 4 ",0,4,0,0,4,4.82
"PRESIDENT OF THE UNITED STATES ",Elizabeth Warren,DM9,"Town of Plattsburgh 5 ",0,0,0,0,0,0.00
"PRESIDENT OF THE UNITED STATES ",Elizabeth Warren,DM9,"Town of Plattsburgh 6 ",0,5,0,3,8,4.47
"PRESIDENT OF THE UNITED STATES ",Elizabeth Warren,DM9,"Town of Plattsburgh 7 ",0,0,0,2,2,3.03
"PRESIDENT OF THE UNITED STATES ",Elizabeth Warren,DM9,"Town of Saranac 1 ",0,5,0,1,6,6.98
"PRESIDENT OF THE UNITED STATES ",Elizabeth Warren,DM9,"Town of Saranac 2 ",0,0,0,0,0,0.00
"PRESIDENT OF THE UNITED STATES ",Elizabeth Warren,DM9,"Town of Saranac 3 ",0,1,0,0,1,2.44
"PRESIDENT OF THE UNITED STATES ",Elizabeth Warren,DM9,"Town of Schuyler Falls 1 ",0,0,0,0,0,0.00
"PRESIDENT OF THE UNITED STATES ",Elizabeth Warren,DM9,"Town of Schuyler Falls 2 ",0,0,0,1,1,1.06
"PRESIDENT OF THE UNITED STATES ",Elizabeth Warren,DM9,"Town of Schuyler Falls 3 ",0,2,0,1,3,4.00
"PRESIDENT OF THE UNITED STATES ",Andrew Yang,DM10,"City of Plattsburgh Ward 1 1 ",0,0,0,1,1,2.04
"PRESIDENT OF THE UNITED STATES ",Andrew Yang,DM10,"City of Plattsburgh Ward 1 2 ",0,0,0,0,0,0.00
"PRESIDENT OF THE UNITED STATES ",Andrew Yang,DM10,"City of Plattsburgh Ward 1 3 ",0,0,0,0,0,0.00
"PRESIDENT OF THE UNITED STATES ",Andrew Yang,DM10,"City of Plattsburgh Ward 2 1 ",0,1,0,0,1,1.10
"PRESIDENT OF THE UNITED STATES ",Andrew Yang,DM10,"City of Plattsburgh Ward 2 2 ",0,2,0,3,5,10.20
"PRESIDENT OF THE UNITED STATES ",Andrew Yang,DM10,"City of Plattsburgh Ward 3 1 ",0,1,0,2,3,2.19
"PRESIDENT OF THE UNITED STATES ",Andrew Yang,DM10,"City of Plattsburgh Ward 3 2 ",0,0,0,1,1,0.55
"PRESIDENT OF THE UNITED STATES ",Andrew Yang,DM10,"City of Plattsburgh Ward 4 1 ",0,0,0,1,1,0.57
"PRESIDENT OF THE UNITED STATES ",Andrew Yang,DM10,"City of Plattsburgh Ward 4 2 ",0,1,0,2,3,1.71
"PRESIDENT OF THE UNITED STATES ",Andrew Yang,DM10,"City of Plattsburgh Ward 5 1 ",0,3,0,0,3,2.65
"PRESIDENT OF THE UNITED STATES ",Andrew Yang,DM10,"City of Plattsburgh Ward 5 2 ",0,2,0,1,3,1.73
"PRESIDENT OF THE UNITED STATES ",Andrew Yang,DM10,"City of Plattsburgh Ward 6 1 ",0,1,0,1,2,1.42
"PRESIDENT OF THE UNITED STATES ",Andrew Yang,DM10,"City of Plattsburgh Ward 6 2 ",0,0,0,1,1,1.18
"PRESIDENT OF THE UNITED STATES ",Andrew Yang,DM10,"Town of Altona 1 ",0,0,0,0,0,0.00
"PRESIDENT OF THE UNITED STATES ",Andrew Yang,DM10,"Town of AuSable 1 ",0,2,0,0,2,3.85
"PRESIDENT OF THE UNITED STATES ",Andrew Yang,DM10,"Town of AuSable 2 ",0,1,0,0,1,1.56
"PRESIDENT OF THE UNITED STATES ",Andrew Yang,DM10,"Town of Beekmantown 1 ",0,0,0,0,0,0.00
"PRESIDENT OF THE UNITED STATES ",Andrew Yang,DM10,"Town of Beekmantown 2 ",0,0,0,0,0,0.00
"PRESIDENT OF THE UNITED STATES ",Andrew Yang,DM10,"Town of Beekmantown 3 ",0,1,0,0,1,0.73
"PRESIDENT OF THE UNITED STATES ",Andrew Yang,DM10,"Town of Beekmantown 4 ",0,0,0,1,1,1.37
"PRESIDENT OF THE UNITED STATES ",Andrew Yang,DM10,"Town of Black Brook 1 ",0,0,0,0,0,0.00
"PRESIDENT OF THE UNITED STATES ",Andrew Yang,DM10,"Town of Black Brook 2 ",0,0,0,0,0,0.00
"PRESIDENT OF THE UNITED STATES ",Andrew Yang,DM10,"Town of Champlain 1 ",0,1,0,0,1,1.22
"PRESIDENT OF THE UNITED STATES ",Andrew Yang,DM10,"Town of Champlain 2 ",0,0,0,0,0,0.00
"PRESIDENT OF THE UNITED STATES ",Andrew Yang,DM10,"Town of Champlain 3 ",0,0,0,0,0,0.00
"PRESIDENT OF THE UNITED STATES ",Andrew Yang,DM10,"Town of Chazy 1 ",0,0,0,0,0,0.00
"PRESIDENT OF THE UNITED STATES ",Andrew Yang,DM10,"Town of Chazy 2 ",0,2,0,0,2,2.17
"PRESIDENT OF THE UNITED STATES ",Andrew Yang,DM10,"Town of Clinton 1 ",0,0,0,0,0,0.00
"PRESIDENT OF THE UNITED STATES ",Andrew Yang,DM10,"Town of Dannemora 1 ",0,0,0,2,2,12.50
"PRESIDENT OF THE UNITED STATES ",Andrew Yang,DM10,"Town of Dannemora 2 ",0,0,0,0,0,0.00
"PRESIDENT OF THE UNITED STATES ",Andrew Yang,DM10,"Town of Dannemora 3 ",0,0,0,0,0,0.00
"PRESIDENT OF THE UNITED STATES ",Andrew Yang,DM10,"Town of Ellenburg 1 ",0,0,0,1,1,1.35
"PRESIDENT OF THE UNITED STATES ",Andrew Yang,DM10,"Town of Mooers 1 ",0,1,0,0,1,1.49
"PRESIDENT OF THE UNITED STATES ",Andrew Yang,DM10,"Town of Mooers 2 ",0,1,0,0,1,3.23
"PRESIDENT OF THE UNITED STATES ",Andrew Yang,DM10,"Town of Peru 1 ",0,1,0,2,3,4.05
"PRESIDENT OF THE UNITED STATES ",Andrew Yang,DM10,"Town of Peru 2 ",0,2,0,0,2,1.79
"PRESIDENT OF THE UNITED STATES ",Andrew Yang,DM10,"Town of Peru 3 ",0,0,0,0,0,0.00
"PRESIDENT OF THE UNITED STATES ",Andrew Yang,DM10,"Town of Peru 4 ",0,0,0,0,0,0.00
"PRESIDENT OF THE UNITED STATES ",Andrew Yang,DM10,"Town of Plattsburgh 1 ",0,1,0,1,2,2.60
"PRESIDENT OF THE UNITED STATES ",Andrew Yang,DM10,"Town of Plattsburgh 2 ",0,1,0,0,1,1.04
"PRESIDENT OF THE UNITED STATES ",Andrew Yang,DM10,"Town of Plattsburgh 3 ",0,0,0,1,1,0.83
"PRESIDENT OF THE UNITED STATES ",Andrew Yang,DM10,"Town of Plattsburgh 4 ",0,1,0,2,3,3.61
"PRESIDENT OF THE UNITED STATES ",Andrew Yang,DM10,"Town of Plattsburgh 5 ",0,0,0,0,0,0.00
"PRESIDENT OF THE UNITED STATES ",Andrew Yang,DM10,"Town of Plattsburgh 6 ",0,2,0,0,2,1.12
"PRESIDENT OF THE UNITED STATES ",Andrew Yang,DM10,"Town of Plattsburgh 7 ",0,0,0,0,0,0.00
"PRESIDENT OF THE UNITED STATES ",Andrew Yang,DM10,"Town of Saranac 1 ",0,0,0,0,0,0.00
"PRESIDENT OF THE UNITED STATES ",Andrew Yang,DM10,"Town of Saranac 2 ",0,0,0,0,0,0.00
"PRESIDENT OF THE UNITED STATES ",Andrew Yang,DM10,"Town of Saranac 3 ",0,0,0,1,1,2.44
"PRESIDENT OF THE UNITED STATES ",Andrew Yang,DM10,"Town of Schuyler Falls 1 ",0,0,0,0,0,0.00
"PRESIDENT OF THE UNITED STATES ",Andrew Yang,DM10,"Town of Schuyler Falls 2 ",0,0,0,1,1,1.06
"PRESIDENT OF THE UNITED STATES ",Andrew Yang,DM10,"Town of Schuyler Falls 3 ",0,1,0,0,1,1.33
"PRESIDENT OF THE UNITED STATES ",Deval Patrick,DM11,"City of Plattsburgh Ward 1 1 ",0,1,0,0,1,2.04
"PRESIDENT OF THE UNITED STATES ",Deval Patrick,DM11,"City of Plattsburgh Ward 1 2 ",0,0,0,0,0,0.00
"PRESIDENT OF THE UNITED STATES ",Deval Patrick,DM11,"City of Plattsburgh Ward 1 3 ",0,0,0,0,0,0.00
"PRESIDENT OF THE UNITED STATES ",Deval Patrick,DM11,"City of Plattsburgh Ward 2 1 ",0,0,0,0,0,0.00
"PRESIDENT OF THE UNITED STATES ",Deval Patrick,DM11,"City of Plattsburgh Ward 2 2 ",0,0,0,0,0,0.00
"PRESIDENT OF THE UNITED STATES ",Deval Patrick,DM11,"City of Plattsburgh Ward 3 1 ",0,0,0,0,0,0.00
"PRESIDENT OF THE UNITED STATES ",Deval Patrick,DM11,"City of Plattsburgh Ward 3 2 ",0,0,0,0,0,0.00
"PRESIDENT OF THE UNITED STATES ",Deval Patrick,DM11,"City of Plattsburgh Ward 4 1 ",0,0,0,0,0,0.00
"PRESIDENT OF THE UNITED STATES ",Deval Patrick,DM11,"City of Plattsburgh Ward 4 2 ",0,0,0,0,0,0.00
"PRESIDENT OF THE UNITED STATES ",Deval Patrick,DM11,"City of Plattsburgh Ward 5 1 ",0,0,0,0,0,0.00
"PRESIDENT OF THE UNITED STATES ",Deval Patrick,DM11,"City of Plattsburgh Ward 5 2 ",0,0,0,0,0,0.00
"PRESIDENT OF THE UNITED STATES ",Deval Patrick,DM11,"City of Plattsburgh Ward 6 1 ",0,0,0,0,0,0.00
"PRESIDENT OF THE UNITED STATES ",Deval Patrick,DM11,"City of Plattsburgh Ward 6 2 ",0,0,0,0,0,0.00
"PRESIDENT OF THE UNITED STATES ",Deval Patrick,DM11,"Town of Altona 1 ",0,0,0,0,0,0.00
"PRESIDENT OF THE UNITED STATES ",Deval Patrick,DM11,"Town of AuSable 1 ",0,0,0,0,0,0.00
"PRESIDENT OF THE UNITED STATES ",Deval Patrick,DM11,"Town of AuSable 2 ",0,0,0,0,0,0.00
"PRESIDENT OF THE UNITED STATES ",Deval Patrick,DM11,"Town of Beekmantown 1 ",0,0,0,0,0,0.00
"PRESIDENT OF THE UNITED STATES ",Deval Patrick,DM11,"Town of Beekmantown 2 ",0,0,0,1,1,1.82
"PRESIDENT OF THE UNITED STATES ",Deval Patrick,DM11,"Town of Beekmantown 3 ",0,0,0,0,0,0.00
"PRESIDENT OF THE UNITED STATES ",Deval Patrick,DM11,"Town of Beekmantown 4 ",0,0,0,0,0,0.00
"PRESIDENT OF THE UNITED STATES ",Deval Patrick,DM11,"Town of Black Brook 1 ",0,0,0,0,0,0.00
"PRESIDENT OF THE UNITED STATES ",Deval Patrick,DM11,"Town of Black Brook 2 ",0,0,0,0,0,0.00
"PRESIDENT OF THE UNITED STATES ",Deval Patrick,DM11,"Town of Champlain 1 ",0,0,0,0,0,0.00
"PRESIDENT OF THE UNITED STATES ",Deval Patrick,DM11,"Town of Champlain 2 ",0,0,0,0,0,0.00
"PRESIDENT OF THE UNITED STATES ",Deval Patrick,DM11,"Town of Champlain 3 ",0,0,0,0,0,0.00
"PRESIDENT OF THE UNITED STATES ",Deval Patrick,DM11,"Town of Chazy 1 ",0,0,0,0,0,0.00
"PRESIDENT OF THE UNITED STATES ",Deval Patrick,DM11,"Town of Chazy 2 ",0,0,0,0,0,0.00
"PRESIDENT OF THE UNITED STATES ",Deval Patrick,DM11,"Town of Clinton 1 ",0,0,0,0,0,0.00
"PRESIDENT OF THE UNITED STATES ",Deval Patrick,DM11,"Town of Dannemora 1 ",0,0,0,0,0,0.00
"PRESIDENT OF THE UNITED STATES ",Deval Patrick,DM11,"Town of Dannemora 2 ",0,0,0,0,0,0.00
"PRESIDENT OF THE UNITED STATES ",Deval Patrick,DM11,"Town of Dannemora 3 ",0,0,0,0,0,0.00
"PRESIDENT OF THE UNITED STATES ",Deval Patrick,DM11,"Town of Ellenburg 1 ",0,0,0,0,0,0.00
"PRESIDENT OF THE UNITED STATES ",Deval Patrick,DM11,"Town of Mooers 1 ",0,1,0,0,1,1.49
"PRESIDENT OF THE UNITED STATES ",Deval Patrick,DM11,"Town of Mooers 2 ",0,0,0,0,0,0.00
"PRESIDENT OF THE UNITED STATES ",Deval Patrick,DM11,"Town of Peru 1 ",0,0,0,1,1,1.35
"PRESIDENT OF THE UNITED STATES ",Deval Patrick,DM11,"Town of Peru 2 ",0,0,0,0,0,0.00
"PRESIDENT OF THE UNITED STATES ",Deval Patrick,DM11,"Town of Peru 3 ",0,0,0,0,0,0.00
"PRESIDENT OF THE UNITED STATES ",Deval Patrick,DM11,"Town of Peru 4 ",0,0,0,0,0,0.00
"PRESIDENT OF THE UNITED STATES ",Deval Patrick,DM11,"Town of Plattsburgh 1 ",0,0,0,1,1,1.30
"PRESIDENT OF THE UNITED STATES ",Deval Patrick,DM11,"Town of Plattsburgh 2 ",0,0,0,0,0,0.00
"PRESIDENT OF THE UNITED STATES ",Deval Patrick,DM11,"Town of Plattsburgh 3 ",0,0,0,0,0,0.00
"PRESIDENT OF THE UNITED STATES ",Deval Patrick,DM11,"Town of Plattsburgh 4 ",0,1,0,0,1,1.20
"PRESIDENT OF THE UNITED STATES ",Deval Patrick,DM11,"Town of Plattsburgh 5 ",0,0,0,0,0,0.00
"PRESIDENT OF THE UNITED STATES ",Deval Patrick,DM11,"Town of Plattsburgh 6 ",0,0,0,0,0,0.00
"PRESIDENT OF THE UNITED STATES ",Deval Patrick,DM11,"Town of Plattsburgh 7 ",0,0,0,0,0,0.00
"PRESIDENT OF THE UNITED STATES ",Deval Patrick,DM11,"Town of Saranac 1 ",0,0,0,0,0,0.00
"PRESIDENT OF THE UNITED STATES ",Deval Patrick,DM11,"Town of Saranac 2 ",0,1,0,0,1,2.08
"PRESIDENT OF THE UNITED STATES ",Deval Patrick,DM11,"Town of Saranac 3 ",0,0,0,0,0,0.00
"PRESIDENT OF THE UNITED STATES ",Deval Patrick,DM11,"Town of Schuyler Falls 1 ",0,0,0,0,0,0.00
"PRESIDENT OF THE UNITED STATES ",Deval Patrick,DM11,"Town of Schuyler Falls 2 ",0,2,0,0,2,2.13
"PRESIDENT OF THE UNITED STATES ",Deval Patrick,DM11,"Town of Schuyler Falls 3 ",0,0,0,0,0,0.00
DELEGATES TO NATIONAL CONVENTION 21st Congressional District,Sarah H. Miller (F),DM1,"City of Plattsburgh Ward 1 1 ",0,4,0,3,7,3.93
DELEGATES TO NATIONAL CONVENTION 21st Congressional District,Sarah H. Miller (F),DM1,"City of Plattsburgh Ward 1 2 ",0,21,0,8,29,2.34
DELEGATES TO NATIONAL CONVENTION 21st Congressional District,Sarah H. Miller (F),DM1,"City of Plattsburgh Ward 1 3 ",0,2,0,0,2,5.56
DELEGATES TO NATIONAL CONVENTION 21st Congressional District,Sarah H. Miller (F),DM1,"City of Plattsburgh Ward 2 1 ",0,2,0,6,8,2.06
DELEGATES TO NATIONAL CONVENTION 21st Congressional District,Sarah H. Miller (F),DM1,"City of Plattsburgh Ward 2 2 ",0,3,0,5,8,3.27
DELEGATES TO NATIONAL CONVENTION 21st Congressional District,Sarah H. Miller (F),DM1,"City of Plattsburgh Ward 3 1 ",0,9,0,4,13,2.37
DELEGATES TO NATIONAL CONVENTION 21st Congressional District,Sarah H. Miller (F),DM1,"City of Plattsburgh Ward 3 2 ",0,11,0,10,21,2.48
DELEGATES TO NATIONAL CONVENTION 21st Congressional District,Sarah H. Miller (F),DM1,"City of Plattsburgh Ward 4 1 ",0,13,0,15,28,3.47
DELEGATES TO NATIONAL CONVENTION 21st Congressional District,Sarah H. Miller (F),DM1,"City of Plattsburgh Ward 4 2 ",0,11,0,9,20,2.50
DELEGATES TO NATIONAL CONVENTION 21st Congressional District,Sarah H. Miller (F),DM1,"City of Plattsburgh Ward 5 1 ",0,11,0,7,18,3.24
DELEGATES TO NATIONAL CONVENTION 21st Congressional District,Sarah H. Miller (F),DM1,"City of Plattsburgh Ward 5 2 ",0,10,0,8,18,2.24
DELEGATES TO NATIONAL CONVENTION 21st Congressional District,Sarah H. Miller (F),DM1,"City of Plattsburgh Ward 6 1 ",0,8,0,13,21,3.11
DELEGATES TO NATIONAL CONVENTION 21st Congressional District,Sarah H. Miller (F),DM1,"City of Plattsburgh Ward 6 2 ",0,4,0,4,8,2.44
DELEGATES TO NATIONAL CONVENTION 21st Congressional District,Sarah H. Miller (F),DM1,"Town of Altona 1 ",0,6,0,7,13,3.13
DELEGATES TO NATIONAL CONVENTION 21st Congressional District,Sarah H. Miller (F),DM1,"Town of AuSable 1 ",0,4,0,7,11,4.42
DELEGATES TO NATIONAL CONVENTION 21st Congressional District,Sarah H. Miller (F),DM1,"Town of AuSable 2 ",0,4,0,5,9,3.38
DELEGATES TO NATIONAL CONVENTION 21st Congressional District,Sarah H. Miller (F),DM1,"Town of Beekmantown 1 ",0,9,0,7,16,4.42
DELEGATES TO NATIONAL CONVENTION 21st Congressional District,Sarah H. Miller (F),DM1,"Town of Beekmantown 2 ",0,5,0,2,7,2.30
DELEGATES TO NATIONAL CONVENTION 21st Congressional District,Sarah H. Miller (F),DM1,"Town of Beekmantown 3 ",0,16,0,3,19,2.54
DELEGATES TO NATIONAL CONVENTION 21st Congressional District,Sarah H. Miller (F),DM1,"Town of Beekmantown 4 ",0,6,0,1,7,1.82
DELEGATES TO NATIONAL CONVENTION 21st Congressional District,Sarah H. Miller (F),DM1,"Town of Black Brook 1 ",0,1,0,4,5,1.86
DELEGATES TO NATIONAL CONVENTION 21st Congressional District,Sarah H. Miller (F),DM1,"Town of Black Brook 2 ",0,1,0,2,3,3.13
DELEGATES TO NATIONAL CONVENTION 21st Congressional District,Sarah H. Miller (F),DM1,"Town of Champlain 1 ",0,5,0,6,11,2.85
DELEGATES TO NATIONAL CONVENTION 21st Congressional District,Sarah H. Miller (F),DM1,"Town of Champlain 2 ",0,9,0,4,13,2.46
DELEGATES TO NATIONAL CONVENTION 21st Congressional District,Sarah H. Miller (F),DM1,"Town of Champlain 3 ",0,6,0,5,11,2.47
DELEGATES TO NATIONAL CONVENTION 21st Congressional District,Sarah H. Miller (F),DM1,"Town of Chazy 1 ",0,11,0,3,14,2.75
DELEGATES TO NATIONAL CONVENTION 21st Congressional District,Sarah H. Miller (F),DM1,"Town of Chazy 2 ",0,13,0,2,15,3.41
DELEGATES TO NATIONAL CONVENTION 21st Congressional District,Sarah H. Miller (F),DM1,"Town of Clinton 1 ",0,2,0,1,3,2.86
DELEGATES TO NATIONAL CONVENTION 21st Congressional District,Sarah H. Miller (F),DM1,"Town of Dannemora 1 ",0,0,0,1,1,1.25
DELEGATES TO NATIONAL CONVENTION 21st Congressional District,Sarah H. Miller (F),DM1,"Town of Dannemora 2 ",0,3,0,1,4,3.17
DELEGATES TO NATIONAL CONVENTION 21st Congressional District,Sarah H. Miller (F),DM1,"Town of Dannemora 3 ",0,1,0,6,7,3.80
DELEGATES TO NATIONAL CONVENTION 21st Congressional District,Sarah H. Miller (F),DM1,"Town of Ellenburg 1 ",0,6,0,3,9,2.54
DELEGATES TO NATIONAL CONVENTION 21st Congressional District,Sarah H. Miller (F),DM1,"Town of Mooers 1 ",0,5,0,6,11,3.28
DELEGATES TO NATIONAL CONVENTION 21st Congressional District,Sarah H. Miller (F),DM1,"Town of Mooers 2 ",0,0,0,2,2,1.43
DELEGATES TO NATIONAL CONVENTION 21st Congressional District,Sarah H. Miller (F),DM1,"Town of Peru 1 ",0,4,0,5,9,2.41
DELEGATES TO NATIONAL CONVENTION 21st Congressional District,Sarah H. Miller (F),DM1,"Town of Peru 2 ",0,7,0,7,14,2.56
DELEGATES TO NATIONAL CONVENTION 21st Congressional District,Sarah H. Miller (F),DM1,"Town of Peru 3 ",0,6,0,2,8,4.02
DELEGATES TO NATIONAL CONVENTION 21st Congressional District,Sarah H. Miller (F),DM1,"Town of Peru 4 ",0,13,0,4,17,3.16
DELEGATES TO NATIONAL CONVENTION 21st Congressional District,Sarah H. Miller (F),DM1,"Town of Plattsburgh 1 ",0,14,0,3,17,4.56
DELEGATES TO NATIONAL CONVENTION 21st Congressional District,Sarah H. Miller (F),DM1,"Town of Plattsburgh 2 ",0,10,0,1,11,2.29
DELEGATES TO NATIONAL CONVENTION 21st Congressional District,Sarah H. Miller (F),DM1,"Town of Plattsburgh 3 ",0,11,0,7,18,2.74
DELEGATES TO NATIONAL CONVENTION 21st Congressional District,Sarah H. Miller (F),DM1,"Town of Plattsburgh 4 ",0,6,0,5,11,2.72
DELEGATES TO NATIONAL CONVENTION 21st Congressional District,Sarah H. Miller (F),DM1,"Town of Plattsburgh 5 ",0,4,0,7,11,3.61
DELEGATES TO NATIONAL CONVENTION 21st Congressional District,Sarah H. Miller (F),DM1,"Town of Plattsburgh 6 ",0,7,0,14,21,2.33
DELEGATES TO NATIONAL CONVENTION 21st Congressional District,Sarah H. Miller (F),DM1,"Town of Plattsburgh 7 ",0,5,0,2,7,2.02
DELEGATES TO NATIONAL CONVENTION 21st Congressional District,Sarah H. Miller (F),DM1,"Town of Saranac 1 ",0,4,0,3,7,1.60
DELEGATES TO NATIONAL CONVENTION 21st Congressional District,Sarah H. Miller (F),DM1,"Town of Saranac 2 ",0,2,0,5,7,2.85
DELEGATES TO NATIONAL CONVENTION 21st Congressional District,Sarah H. Miller (F),DM1,"Town of Saranac 3 ",0,2,0,3,5,2.40
DELEGATES TO NATIONAL CONVENTION 21st Congressional District,Sarah H. Miller (F),DM1,"Town of Schuyler Falls 1 ",0,7,0,3,10,6.29
DELEGATES TO NATIONAL CONVENTION 21st Congressional District,Sarah H. Miller (F),DM1,"Town of Schuyler Falls 2 ",0,18,0,2,20,4.42
DELEGATES TO NATIONAL CONVENTION 21st Congressional District,Sarah H. Miller (F),DM1,"Town of Schuyler Falls 3 ",0,8,0,4,12,3.23
DELEGATES TO NATIONAL CONVENTION 21st Congressional District,Dwight H. Stevenson (M),DM1,"City of Plattsburgh Ward 1 1 ",0,3,0,1,4,2.25
DELEGATES TO NATIONAL CONVENTION 21st Congressional District,Dwight H. Stevenson (M),DM1,"City of Plattsburgh Ward 1 2 ",0,4,0,4,8,0.65
DELEGATES TO NATIONAL CONVENTION 21st Congressional District,Dwight H. Stevenson (M),DM1,"City of Plattsburgh Ward 1 3 ",0,1,0,0,1,2.78
DELEGATES TO NATIONAL CONVENTION 21st Congressional District,Dwight H. Stevenson (M),DM1,"City of Plattsburgh Ward 2 1 ",0,0,0,2,2,0.51
DELEGATES TO NATIONAL CONVENTION 21st Congressional District,Dwight H. Stevenson (M),DM1,"City of Plattsburgh Ward 2 2 ",0,0,0,3,3,1.22
DELEGATES TO NATIONAL CONVENTION 21st Congressional District,Dwight H. Stevenson (M),DM1,"City of Plattsburgh Ward 3 1 ",0,0,0,4,4,0.73
DELEGATES TO NATIONAL CONVENTION 21st Congressional District,Dwight H. Stevenson (M),DM1,"City of Plattsburgh Ward 3 2 ",0,2,0,4,6,0.71
DELEGATES TO NATIONAL CONVENTION 21st Congressional District,Dwight H. Stevenson (M),DM1,"City of Plattsburgh Ward 4 1 ",0,2,0,0,2,0.25
DELEGATES TO NATIONAL CONVENTION 21st Congressional District,Dwight H. Stevenson (M),DM1,"City of Plattsburgh Ward 4 2 ",0,3,0,5,8,1.00
DELEGATES TO NATIONAL CONVENTION 21st Congressional District,Dwight H. Stevenson (M),DM1,"City of Plattsburgh Ward 5 1 ",0,5,0,0,5,0.90
DELEGATES TO NATIONAL CONVENTION 21st Congressional District,Dwight H. Stevenson (M),DM1,"City of Plattsburgh Ward 5 2 ",0,2,0,1,3,0.37
DELEGATES TO NATIONAL CONVENTION 21st Congressional District,Dwight H. Stevenson (M),DM1,"City of Plattsburgh Ward 6 1 ",0,2,0,2,4,0.59
DELEGATES TO NATIONAL CONVENTION 21st Congressional District,Dwight H. Stevenson (M),DM1,"City of Plattsburgh Ward 6 2 ",0,1,0,2,3,0.91
DELEGATES TO NATIONAL CONVENTION 21st Congressional District,Dwight H. Stevenson (M),DM1,"Town of Altona 1 ",0,3,0,3,6,1.45
DELEGATES TO NATIONAL CONVENTION 21st Congressional District,Dwight H. Stevenson (M),DM1,"Town of AuSable 1 ",0,3,0,3,6,2.41
DELEGATES TO NATIONAL CONVENTION 21st Congressional District,Dwight H. Stevenson (M),DM1,"Town of AuSable 2 ",0,1,0,1,2,0.75
DELEGATES TO NATIONAL CONVENTION 21st Congressional District,Dwight H. Stevenson (M),DM1,"Town of Beekmantown 1 ",0,2,0,1,3,0.83
DELEGATES TO NATIONAL CONVENTION 21st Congressional District,Dwight H. Stevenson (M),DM1,"Town of Beekmantown 2 ",0,4,0,1,5,1.64
DELEGATES TO NATIONAL CONVENTION 21st Congressional District,Dwight H. Stevenson (M),DM1,"Town of Beekmantown 3 ",0,3,0,2,5,0.67
DELEGATES TO NATIONAL CONVENTION 21st Congressional District,Dwight H. Stevenson (M),DM1,"Town of Beekmantown 4 ",0,1,0,2,3,0.78
DELEGATES TO NATIONAL CONVENTION 21st Congressional District,Dwight H. Stevenson (M),DM1,"Town of Black Brook 1 ",0,1,0,0,1,0.37
DELEGATES TO NATIONAL CONVENTION 21st Congressional District,Dwight H. Stevenson (M),DM1,"Town of Black Brook 2 ",0,1,0,1,2,2.08
DELEGATES TO NATIONAL CONVENTION 21st Congressional District,Dwight H. Stevenson (M),DM1,"Town of Champlain 1 ",0,2,0,0,2,0.52
DELEGATES TO NATIONAL CONVENTION 21st Congressional District,Dwight H. Stevenson (M),DM1,"Town of Champlain 2 ",0,7,0,1,8,1.51
DELEGATES TO NATIONAL CONVENTION 21st Congressional District,Dwight H. Stevenson (M),DM1,"Town of Champlain 3 ",0,0,0,3,3,0.67
DELEGATES TO NATIONAL CONVENTION 21st Congressional District,Dwight H. Stevenson (M),DM1,"Town of Chazy 1 ",0,3,0,1,4,0.79
DELEGATES TO NATIONAL CONVENTION 21st Congressional District,Dwight H. Stevenson (M),DM1,"Town of Chazy 2 ",0,3,0,0,3,0.68
DELEGATES TO NATIONAL CONVENTION 21st Congressional District,Dwight H. Stevenson (M),DM1,"Town of Clinton 1 ",0,2,0,0,2,1.90
DELEGATES TO NATIONAL CONVENTION 21st Congressional District,Dwight H. Stevenson (M),DM1,"Town of Dannemora 1 ",0,0,0,1,1,1.25
DELEGATES TO NATIONAL CONVENTION 21st Congressional District,Dwight H. Stevenson (M),DM1,"Town of Dannemora 2 ",0,0,0,1,1,0.79
DELEGATES TO NATIONAL CONVENTION 21st Congressional District,Dwight H. Stevenson (M),DM1,"Town of Dannemora 3 ",0,0,0,2,2,1.09
DELEGATES TO NATIONAL CONVENTION 21st Congressional District,Dwight H. Stevenson (M),DM1,"Town of Ellenburg 1 ",0,0,0,1,1,0.28
DELEGATES TO NATIONAL CONVENTION 21st Congressional District,Dwight H. Stevenson (M),DM1,"Town of Mooers 1 ",0,5,0,0,5,1.49
DELEGATES TO NATIONAL CONVENTION 21st Congressional District,Dwight H. Stevenson (M),DM1,"Town of Mooers 2 ",0,1,0,0,1,0.71
DELEGATES TO NATIONAL CONVENTION 21st Congressional District,Dwight H. Stevenson (M),DM1,"Town of Peru 1 ",0,4,0,1,5,1.34
DELEGATES TO NATIONAL CONVENTION 21st Congressional District,Dwight H. Stevenson (M),DM1,"Town of Peru 2 ",0,2,0,3,5,0.92
DELEGATES TO NATIONAL CONVENTION 21st Congressional District,Dwight H. Stevenson (M),DM1,"Town of Peru 3 ",0,2,0,0,2,1.01
DELEGATES TO NATIONAL CONVENTION 21st Congressional District,Dwight H. Stevenson (M),DM1,"Town of Peru 4 ",0,6,0,2,8,1.49
DELEGATES TO NATIONAL CONVENTION 21st Congressional District,Dwight H. Stevenson (M),DM1,"Town of Plattsburgh 1 ",0,7,0,1,8,2.14
DELEGATES TO NATIONAL CONVENTION 21st Congressional District,Dwight H. Stevenson (M),DM1,"Town of Plattsburgh 2 ",0,6,0,1,7,1.46
DELEGATES TO NATIONAL CONVENTION 21st Congressional District,Dwight H. Stevenson (M),DM1,"Town of Plattsburgh 3 ",0,3,0,1,4,0.61
DELEGATES TO NATIONAL CONVENTION 21st Congressional District,Dwight H. Stevenson (M),DM1,"Town of Plattsburgh 4 ",0,5,0,3,8,1.98
DELEGATES TO NATIONAL CONVENTION 21st Congressional District,Dwight H. Stevenson (M),DM1,"Town of Plattsburgh 5 ",0,2,0,3,5,1.64
DELEGATES TO NATIONAL CONVENTION 21st Congressional District,Dwight H. Stevenson (M),DM1,"Town of Plattsburgh 6 ",0,1,0,4,5,0.56
DELEGATES TO NATIONAL CONVENTION 21st Congressional District,Dwight H. Stevenson (M),DM1,"Town of Plattsburgh 7 ",0,5,0,1,6,1.73
DELEGATES TO NATIONAL CONVENTION 21st Congressional District,Dwight H. Stevenson (M),DM1,"Town of Saranac 1 ",0,5,0,0,5,1.14
DELEGATES TO NATIONAL CONVENTION 21st Congressional District,Dwight H. Stevenson (M),DM1,"Town of Saranac 2 ",0,1,0,1,2,0.81
DELEGATES TO NATIONAL CONVENTION 21st Congressional District,Dwight H. Stevenson (M),DM1,"Town of Saranac 3 ",0,0,0,1,1,0.48
DELEGATES TO NATIONAL CONVENTION 21st Congressional District,Dwight H. Stevenson (M),DM1,"Town of Schuyler Falls 1 ",0,3,0,0,3,1.89
DELEGATES TO NATIONAL CONVENTION 21st Congressional District,Dwight H. Stevenson (M),DM1,"Town of Schuyler Falls 2 ",0,4,0,1,5,1.11
DELEGATES TO NATIONAL CONVENTION 21st Congressional District,Dwight H. Stevenson (M),DM1,"Town of Schuyler Falls 3 ",0,3,0,1,4,1.08
DELEGATES TO NATIONAL CONVENTION 21st Congressional District,Sarah M. Tucci (F),DM1,"City of Plattsburgh Ward 1 1 ",0,2,0,2,4,2.25
DELEGATES TO NATIONAL CONVENTION 21st Congressional District,Sarah M. Tucci (F),DM1,"City of Plattsburgh Ward 1 2 ",0,15,0,10,25,2.02
DELEGATES TO NATIONAL CONVENTION 21st Congressional District,Sarah M. Tucci (F),DM1,"City of Plattsburgh Ward 1 3 ",0,1,0,0,1,2.78
DELEGATES TO NATIONAL CONVENTION 21st Congressional District,Sarah M. Tucci (F),DM1,"City of Plattsburgh Ward 2 1 ",0,3,0,8,11,2.83
DELEGATES TO NATIONAL CONVENTION 21st Congressional District,Sarah M. Tucci (F),DM1,"City of Plattsburgh Ward 2 2 ",0,3,0,2,5,2.04
DELEGATES TO NATIONAL CONVENTION 21st Congressional District,Sarah M. Tucci (F),DM1,"City of Plattsburgh Ward 3 1 ",0,6,0,4,10,1.82
DELEGATES TO NATIONAL CONVENTION 21st Congressional District,Sarah M. Tucci (F),DM1,"City of Plattsburgh Ward 3 2 ",0,13,0,11,24,2.84
DELEGATES TO NATIONAL CONVENTION 21st Congressional District,Sarah M. Tucci (F),DM1,"City of Plattsburgh Ward 4 1 ",0,8,0,11,19,2.36
DELEGATES TO NATIONAL CONVENTION 21st Congressional District,Sarah M. Tucci (F),DM1,"City of Plattsburgh Ward 4 2 ",0,5,0,7,12,1.50
DELEGATES TO NATIONAL CONVENTION 21st Congressional District,Sarah M. Tucci (F),DM1,"City of Plattsburgh Ward 5 1 ",0,14,0,6,20,3.60
DELEGATES TO NATIONAL CONVENTION 21st Congressional District,Sarah M. Tucci (F),DM1,"City of Plattsburgh Ward 5 2 ",0,10,0,4,14,1.74
DELEGATES TO NATIONAL CONVENTION 21st Congressional District,Sarah M. Tucci (F),DM1,"City of Plattsburgh Ward 6 1 ",0,5,0,6,11,1.63
DELEGATES TO NATIONAL CONVENTION 21st Congressional District,Sarah M. Tucci (F),DM1,"City of Plattsburgh Ward 6 2 ",0,5,0,7,12,3.66
DELEGATES TO NATIONAL CONVENTION 21st Congressional District,Sarah M. Tucci (F),DM1,"Town of Altona 1 ",0,7,0,4,11,2.65
DELEGATES TO NATIONAL CONVENTION 21st Congressional District,Sarah M. Tucci (F),DM1,"Town of AuSable 1 ",0,3,0,7,10,4.02
DELEGATES TO NATIONAL CONVENTION 21st Congressional District,Sarah M. Tucci (F),DM1,"Town of AuSable 2 ",0,5,0,4,9,3.38
DELEGATES TO NATIONAL CONVENTION 21st Congressional District,Sarah M. Tucci (F),DM1,"Town of Beekmantown 1 ",0,6,0,5,11,3.04
DELEGATES TO NATIONAL CONVENTION 21st Congressional District,Sarah M. Tucci (F),DM1,"Town of Beekmantown 2 ",0,5,0,1,6,1.97
DELEGATES TO NATIONAL CONVENTION 21st Congressional District,Sarah M. Tucci (F),DM1,"Town of Beekmantown 3 ",0,4,0,3,7,0.94
DELEGATES TO NATIONAL CONVENTION 21st Congressional District,Sarah M. Tucci (F),DM1,"Town of Beekmantown 4 ",0,7,0,1,8,2.08
DELEGATES TO NATIONAL CONVENTION 21st Congressional District,Sarah M. Tucci (F),DM1,"Town of Black Brook 1 ",0,3,0,1,4,1.49
DELEGATES TO NATIONAL CONVENTION 21st Congressional District,Sarah M. Tucci (F),DM1,"Town of Black Brook 2 ",0,1,0,1,2,2.08
DELEGATES TO NATIONAL CONVENTION 21st Congressional District,Sarah M. Tucci (F),DM1,"Town of Champlain 1 ",0,6,0,2,8,2.07
DELEGATES TO NATIONAL CONVENTION 21st Congressional District,Sarah M. Tucci (F),DM1,"Town of Champlain 2 ",0,12,0,4,16,3.02
DELEGATES TO NATIONAL CONVENTION 21st Congressional District,Sarah M. Tucci (F),DM1,"Town of Champlain 3 ",0,5,0,6,11,2.47
DELEGATES TO NATIONAL CONVENTION 21st Congressional District,Sarah M. Tucci (F),DM1,"Town of Chazy 1 ",0,6,0,4,10,1.96
DELEGATES TO NATIONAL CONVENTION 21st Congressional District,Sarah M. Tucci (F),DM1,"Town of Chazy 2 ",0,11,0,1,12,2.73
DELEGATES TO NATIONAL CONVENTION 21st Congressional District,Sarah M. Tucci (F),DM1,"Town of Clinton 1 ",0,3,0,0,3,2.86
DELEGATES TO NATIONAL CONVENTION 21st Congressional District,Sarah M. Tucci (F),DM1,"Town of Dannemora 1 ",0,0,0,2,2,2.50
DELEGATES TO NATIONAL CONVENTION 21st Congressional District,Sarah M. Tucci (F),DM1,"Town of Dannemora 2 ",0,2,0,1,3,2.38
DELEGATES TO NATIONAL CONVENTION 21st Congressional District,Sarah M. Tucci (F),DM1,"Town of Dannemora 3 ",0,2,0,5,7,3.80
DELEGATES TO NATIONAL CONVENTION 21st Congressional District,Sarah M. Tucci (F),DM1,"Town of Ellenburg 1 ",0,4,0,5,9,2.54
DELEGATES TO NATIONAL CONVENTION 21st Congressional District,Sarah M. Tucci (F),DM1,"Town of Mooers 1 ",0,5,0,7,12,3.58
DELEGATES TO NATIONAL CONVENTION 21st Congressional District,Sarah M. Tucci (F),DM1,"Town of Mooers 2 ",0,0,0,2,2,1.43
DELEGATES TO NATIONAL CONVENTION 21st Congressional District,Sarah M. Tucci (F),DM1,"Town of Peru 1 ",0,4,0,3,7,1.88
DELEGATES TO NATIONAL CONVENTION 21st Congressional District,Sarah M. Tucci (F),DM1,"Town of Peru 2 ",0,9,0,9,18,3.30
DELEGATES TO NATIONAL CONVENTION 21st Congressional District,Sarah M. Tucci (F),DM1,"Town of Peru 3 ",0,6,0,3,9,4.52
DELEGATES TO NATIONAL CONVENTION 21st Congressional District,Sarah M. Tucci (F),DM1,"Town of Peru 4 ",0,3,0,5,8,1.49
DELEGATES TO NATIONAL CONVENTION 21st Congressional District,Sarah M. Tucci (F),DM1,"Town of Plattsburgh 1 ",0,10,0,2,12,3.22
DELEGATES TO NATIONAL CONVENTION 21st Congressional District,Sarah M. Tucci (F),DM1,"Town of Plattsburgh 2 ",0,5,0,1,6,1.25
DELEGATES TO NATIONAL CONVENTION 21st Congressional District,Sarah M. Tucci (F),DM1,"Town of Plattsburgh 3 ",0,5,0,3,8,1.22
DELEGATES TO NATIONAL CONVENTION 21st Congressional District,Sarah M. Tucci (F),DM1,"Town of Plattsburgh 4 ",0,3,0,4,7,1.73
DELEGATES TO NATIONAL CONVENTION 21st Congressional District,Sarah M. Tucci (F),DM1,"Town of Plattsburgh 5 ",0,3,0,5,8,2.62
DELEGATES TO NATIONAL CONVENTION 21st Congressional District,Sarah M. Tucci (F),DM1,"Town of Plattsburgh 6 ",0,8,0,9,17,1.89
DELEGATES TO NATIONAL CONVENTION 21st Congressional District,Sarah M. Tucci (F),DM1,"Town of Plattsburgh 7 ",0,4,0,1,5,1.44
DELEGATES TO NATIONAL CONVENTION 21st Congressional District,Sarah M. Tucci (F),DM1,"Town of Saranac 1 ",0,7,0,4,11,2.51
DELEGATES TO NATIONAL CONVENTION 21st Congressional District,Sarah M. Tucci (F),DM1,"Town of Saranac 2 ",0,2,0,3,5,2.03
DELEGATES TO NATIONAL CONVENTION 21st Congressional District,Sarah M. Tucci (F),DM1,"Town of Saranac 3 ",0,0,0,7,7,3.37
DELEGATES TO NATIONAL CONVENTION 21st Congressional District,Sarah M. Tucci (F),DM1,"Town of Schuyler Falls 1 ",0,4,0,1,5,3.14
DELEGATES TO NATIONAL CONVENTION 21st Congressional District,Sarah M. Tucci (F),DM1,"Town of Schuyler Falls 2 ",0,11,0,2,13,2.88
DELEGATES TO NATIONAL CONVENTION 21st Congressional District,Sarah M. Tucci (F),DM1,"Town of Schuyler Falls 3 ",0,9,0,5,14,3.77
DELEGATES TO NATIONAL CONVENTION 21st Congressional District,Gregory D. Young (M),DM1,"City of Plattsburgh Ward 1 1 ",0,3,0,0,3,1.69
DELEGATES TO NATIONAL CONVENTION 21st Congressional District,Gregory D. Young (M),DM1,"City of Plattsburgh Ward 1 2 ",0,9,0,4,13,1.05
DELEGATES TO NATIONAL CONVENTION 21st Congressional District,Gregory D. Young (M),DM1,"City of Plattsburgh Ward 1 3 ",0,1,0,0,1,2.78
DELEGATES TO NATIONAL CONVENTION 21st Congressional District,Gregory D. Young (M),DM1,"City of Plattsburgh Ward 2 1 ",0,1,0,3,4,1.03
DELEGATES TO NATIONAL CONVENTION 21st Congressional District,Gregory D. Young (M),DM1,"City of Plattsburgh Ward 2 2 ",0,4,0,4,8,3.27
DELEGATES TO NATIONAL CONVENTION 21st Congressional District,Gregory D. Young (M),DM1,"City of Plattsburgh Ward 3 1 ",0,4,0,4,8,1.46
DELEGATES TO NATIONAL CONVENTION 21st Congressional District,Gregory D. Young (M),DM1,"City of Plattsburgh Ward 3 2 ",0,5,0,6,11,1.30
DELEGATES TO NATIONAL CONVENTION 21st Congressional District,Gregory D. Young (M),DM1,"City of Plattsburgh Ward 4 1 ",0,4,0,1,5,0.62
DELEGATES TO NATIONAL CONVENTION 21st Congressional District,Gregory D. Young (M),DM1,"City of Plattsburgh Ward 4 2 ",0,5,0,4,9,1.13
DELEGATES TO NATIONAL CONVENTION 21st Congressional District,Gregory D. Young (M),DM1,"City of Plattsburgh Ward 5 1 ",0,5,0,1,6,1.08
DELEGATES TO NATIONAL CONVENTION 21st Congressional District,Gregory D. Young (M),DM1,"City of Plattsburgh Ward 5 2 ",0,5,0,1,6,0.75
DELEGATES TO NATIONAL CONVENTION 21st Congressional District,Gregory D. Young (M),DM1,"City of Plattsburgh Ward 6 1 ",0,1,0,3,4,0.59
DELEGATES TO NATIONAL CONVENTION 21st Congressional District,Gregory D. Young (M),DM1,"City of Plattsburgh Ward 6 2 ",0,2,0,2,4,1.22
DELEGATES TO NATIONAL CONVENTION 21st Congressional District,Gregory D. Young (M),DM1,"Town of Altona 1 ",0,5,0,3,8,1.93
DELEGATES TO NATIONAL CONVENTION 21st Congressional District,Gregory D. Young (M),DM1,"Town of AuSable 1 ",0,3,0,3,6,2.41
DELEGATES TO NATIONAL CONVENTION 21st Congressional District,Gregory D. Young (M),DM1,"Town of AuSable 2 ",0,3,0,1,4,1.50
DELEGATES TO NATIONAL CONVENTION 21st Congressional District,Gregory D. Young (M),DM1,"Town of Beekmantown 1 ",0,6,0,2,8,2.21
DELEGATES TO NATIONAL CONVENTION 21st Congressional District,Gregory D. Young (M),DM1,"Town of Beekmantown 2 ",0,4,0,2,6,1.97
DELEGATES TO NATIONAL CONVENTION 21st Congressional District,Gregory D. Young (M),DM1,"Town of Beekmantown 3 ",0,4,0,1,5,0.67
DELEGATES TO NATIONAL CONVENTION 21st Congressional District,Gregory D. Young (M),DM1,"Town of Beekmantown 4 ",0,2,0,0,2,0.52
DELEGATES TO NATIONAL CONVENTION 21st Congressional District,Gregory D. Young (M),DM1,"Town of Black Brook 1 ",0,1,0,1,2,0.74
DELEGATES TO NATIONAL CONVENTION 21st Congressional District,Gregory D. Young (M),DM1,"Town of Black Brook 2 ",0,1,0,2,3,3.13
DELEGATES TO NATIONAL CONVENTION 21st Congressional District,Gregory D. Young (M),DM1,"Town of Champlain 1 ",0,2,0,4,6,1.55
DELEGATES TO NATIONAL CONVENTION 21st Congressional District,Gregory D. Young (M),DM1,"Town of Champlain 2 ",0,5,0,2,7,1.32
DELEGATES TO NATIONAL CONVENTION 21st Congressional District,Gregory D. Young (M),DM1,"Town of Champlain 3 ",0,5,0,2,7,1.57
DELEGATES TO NATIONAL CONVENTION 21st Congressional District,Gregory D. Young (M),DM1,"Town of Chazy 1 ",0,2,0,0,2,0.39
DELEGATES TO NATIONAL CONVENTION 21st Congressional District,Gregory D. Young (M),DM1,"Town of Chazy 2 ",0,3,0,2,5,1.14
DELEGATES TO NATIONAL CONVENTION 21st Congressional District,Gregory D. Young (M),DM1,"Town of Clinton 1 ",0,5,0,2,7,6.67
DELEGATES TO NATIONAL CONVENTION 21st Congressional District,Gregory D. Young (M),DM1,"Town of Dannemora 1 ",0,0,0,1,1,1.25
DELEGATES TO NATIONAL CONVENTION 21st Congressional District,Gregory D. Young (M),DM1,"Town of Dannemora 2 ",0,1,0,0,1,0.79
DELEGATES TO NATIONAL CONVENTION 21st Congressional District,Gregory D. Young (M),DM1,"Town of Dannemora 3 ",0,0,0,2,2,1.09
DELEGATES TO NATIONAL CONVENTION 21st Congressional District,Gregory D. Young (M),DM1,"Town of Ellenburg 1 ",0,6,0,2,8,2.25
DELEGATES TO NATIONAL CONVENTION 21st Congressional District,Gregory D. Young (M),DM1,"Town of Mooers 1 ",0,7,0,4,11,3.28
DELEGATES TO NATIONAL CONVENTION 21st Congressional District,Gregory D. Young (M),DM1,"Town of Mooers 2 ",0,1,0,1,2,1.43
DELEGATES TO NATIONAL CONVENTION 21st Congressional District,Gregory D. Young (M),DM1,"Town of Peru 1 ",0,3,0,2,5,1.34
DELEGATES TO NATIONAL CONVENTION 21st Congressional District,Gregory D. Young (M),DM1,"Town of Peru 2 ",0,2,0,3,5,0.92
DELEGATES TO NATIONAL CONVENTION 21st Congressional District,Gregory D. Young (M),DM1,"Town of Peru 3 ",0,3,0,1,4,2.01
DELEGATES TO NATIONAL CONVENTION 21st Congressional District,Gregory D. Young (M),DM1,"Town of Peru 4 ",0,1,0,3,4,0.74
DELEGATES TO NATIONAL CONVENTION 21st Congressional District,Gregory D. Young (M),DM1,"Town of Plattsburgh 1 ",0,8,0,3,11,2.95
DELEGATES TO NATIONAL CONVENTION 21st Congressional District,Gregory D. Young (M),DM1,"Town of Plattsburgh 2 ",0,7,0,1,8,1.66
DELEGATES TO NATIONAL CONVENTION 21st Congressional District,Gregory D. Young (M),DM1,"Town of Plattsburgh 3 ",0,4,0,5,9,1.37
DELEGATES TO NATIONAL CONVENTION 21st Congressional District,Gregory D. Young (M),DM1,"Town of Plattsburgh 4 ",0,5,0,3,8,1.98
DELEGATES TO NATIONAL CONVENTION 21st Congressional District,Gregory D. Young (M),DM1,"Town of Plattsburgh 5 ",0,4,0,3,7,2.30
DELEGATES TO NATIONAL CONVENTION 21st Congressional District,Gregory D. Young (M),DM1,"Town of Plattsburgh 6 ",0,3,0,4,7,0.78
DELEGATES TO NATIONAL CONVENTION 21st Congressional District,Gregory D. Young (M),DM1,"Town of Plattsburgh 7 ",0,3,0,1,4,1.15
DELEGATES TO NATIONAL CONVENTION 21st Congressional District,Gregory D. Young (M),DM1,"Town of Saranac 1 ",0,3,0,0,3,0.68
DELEGATES TO NATIONAL CONVENTION 21st Congressional District,Gregory D. Young (M),DM1,"Town of Saranac 2 ",0,2,0,1,3,1.22
DELEGATES TO NATIONAL CONVENTION 21st Congressional District,Gregory D. Young (M),DM1,"Town of Saranac 3 ",0,0,0,2,2,0.96
DELEGATES TO NATIONAL CONVENTION 21st Congressional District,Gregory D. Young (M),DM1,"Town of Schuyler Falls 1 ",0,6,0,1,7,4.40
DELEGATES TO NATIONAL CONVENTION 21st Congressional District,Gregory D. Young (M),DM1,"Town of Schuyler Falls 2 ",0,5,0,2,7,1.55
DELEGATES TO NATIONAL CONVENTION 21st Congressional District,Gregory D. Young (M),DM1,"Town of Schuyler Falls 3 ",0,2,0,3,5,1.35
DELEGATES TO NATIONAL CONVENTION 21st Congressional District,Michele L. Hill-Davis (F),DM1,"City of Plattsburgh Ward 1 1 ",0,4,0,1,5,2.81
DELEGATES TO NATIONAL CONVENTION 21st Congressional District,Michele L. Hill-Davis (F),DM1,"City of Plattsburgh Ward 1 2 ",0,14,0,8,22,1.78
DELEGATES TO NATIONAL CONVENTION 21st Congressional District,Michele L. Hill-Davis (F),DM1,"City of Plattsburgh Ward 1 3 ",0,1,0,0,1,2.78
DELEGATES TO NATIONAL CONVENTION 21st Congressional District,Michele L. Hill-Davis (F),DM1,"City of Plattsburgh Ward 2 1 ",0,2,0,1,3,0.77
DELEGATES TO NATIONAL CONVENTION 21st Congressional District,Michele L. Hill-Davis (F),DM1,"City of Plattsburgh Ward 2 2 ",0,2,0,1,3,1.22
DELEGATES TO NATIONAL CONVENTION 21st Congressional District,Michele L. Hill-Davis (F),DM1,"City of Plattsburgh Ward 3 1 ",0,4,0,3,7,1.28
DELEGATES TO NATIONAL CONVENTION 21st Congressional District,Michele L. Hill-Davis (F),DM1,"City of Plattsburgh Ward 3 2 ",0,12,0,8,20,2.36
DELEGATES TO NATIONAL CONVENTION 21st Congressional District,Michele L. Hill-Davis (F),DM1,"City of Plattsburgh Ward 4 1 ",0,5,0,10,15,1.86
DELEGATES TO NATIONAL CONVENTION 21st Congressional District,Michele L. Hill-Davis (F),DM1,"City of Plattsburgh Ward 4 2 ",0,10,0,5,15,1.88
DELEGATES TO NATIONAL CONVENTION 21st Congressional District,Michele L. Hill-Davis (F),DM1,"City of Plattsburgh Ward 5 1 ",0,9,0,7,16,2.88
DELEGATES TO NATIONAL CONVENTION 21st Congressional District,Michele L. Hill-Davis (F),DM1,"City of Plattsburgh Ward 5 2 ",0,7,0,6,13,1.62
DELEGATES TO NATIONAL CONVENTION 21st Congressional District,Michele L. Hill-Davis (F),DM1,"City of Plattsburgh Ward 6 1 ",0,7,0,7,14,2.07
DELEGATES TO NATIONAL CONVENTION 21st Congressional District,Michele L. Hill-Davis (F),DM1,"City of Plattsburgh Ward 6 2 ",0,2,0,7,9,2.74
DELEGATES TO NATIONAL CONVENTION 21st Congressional District,Michele L. Hill-Davis (F),DM1,"Town of Altona 1 ",0,2,0,3,5,1.20
DELEGATES TO NATIONAL CONVENTION 21st Congressional District,Michele L. Hill-Davis (F),DM1,"Town of AuSable 1 ",0,4,0,5,9,3.61
DELEGATES TO NATIONAL CONVENTION 21st Congressional District,Michele L. Hill-Davis (F),DM1,"Town of AuSable 2 ",0,3,0,0,3,1.13
DELEGATES TO NATIONAL CONVENTION 21st Congressional District,Michele L. Hill-Davis (F),DM1,"Town of Beekmantown 1 ",0,3,0,2,5,1.38
DELEGATES TO NATIONAL CONVENTION 21st Congressional District,Michele L. Hill-Davis (F),DM1,"Town of Beekmantown 2 ",0,5,0,1,6,1.97
DELEGATES TO NATIONAL CONVENTION 21st Congressional District,Michele L. Hill-Davis (F),DM1,"Town of Beekmantown 3 ",0,4,0,4,8,1.07
DELEGATES TO NATIONAL CONVENTION 21st Congressional District,Michele L. Hill-Davis (F),DM1,"Town of Beekmantown 4 ",0,3,0,1,4,1.04
DELEGATES TO NATIONAL CONVENTION 21st Congressional District,Michele L. Hill-Davis (F),DM1,"Town of Black Brook 1 ",0,0,0,1,1,0.37
DELEGATES TO NATIONAL CONVENTION 21st Congressional District,Michele L. Hill-Davis (F),DM1,"Town of Black Brook 2 ",0,1,0,1,2,2.08
DELEGATES TO NATIONAL CONVENTION 21st Congressional District,Michele L. Hill-Davis (F),DM1,"Town of Champlain 1 ",0,3,0,0,3,0.78
DELEGATES TO NATIONAL CONVENTION 21st Congressional District,Michele L. Hill-Davis (F),DM1,"Town of Champlain 2 ",0,10,0,0,10,1.89
DELEGATES TO NATIONAL CONVENTION 21st Congressional District,Michele L. Hill-Davis (F),DM1,"Town of Champlain 3 ",0,4,0,1,5,1.12
DELEGATES TO NATIONAL CONVENTION 21st Congressional District,Michele L. Hill-Davis (F),DM1,"Town of Chazy 1 ",0,4,0,1,5,0.98
DELEGATES TO NATIONAL CONVENTION 21st Congressional District,Michele L. Hill-Davis (F),DM1,"Town of Chazy 2 ",0,11,0,3,14,3.18
DELEGATES TO NATIONAL CONVENTION 21st Congressional District,Michele L. Hill-Davis (F),DM1,"Town of Clinton 1 ",0,3,0,0,3,2.86
DELEGATES TO NATIONAL CONVENTION 21st Congressional District,Michele L. Hill-Davis (F),DM1,"Town of Dannemora 1 ",0,0,0,2,2,2.50
DELEGATES TO NATIONAL CONVENTION 21st Congressional District,Michele L. Hill-Davis (F),DM1,"Town of Dannemora 2 ",0,2,0,3,5,3.97
DELEGATES TO NATIONAL CONVENTION 21st Congressional District,Michele L. Hill-Davis (F),DM1,"Town of Dannemora 3 ",0,1,0,3,4,2.17
DELEGATES TO NATIONAL CONVENTION 21st Congressional District,Michele L. Hill-Davis (F),DM1,"Town of Ellenburg 1 ",0,5,0,3,8,2.25
DELEGATES TO NATIONAL CONVENTION 21st Congressional District,Michele L. Hill-Davis (F),DM1,"Town of Mooers 1 ",0,4,0,0,4,1.19
DELEGATES TO NATIONAL CONVENTION 21st Congressional District,Michele L. Hill-Davis (F),DM1,"Town of Mooers 2 ",0,0,0,3,3,2.14
DELEGATES TO NATIONAL CONVENTION 21st Congressional District,Michele L. Hill-Davis (F),DM1,"Town of Peru 1 ",0,5,0,4,9,2.41
DELEGATES TO NATIONAL CONVENTION 21st Congressional District,Michele L. Hill-Davis (F),DM1,"Town of Peru 2 ",0,5,0,5,10,1.83
DELEGATES TO NATIONAL CONVENTION 21st Congressional District,Michele L. Hill-Davis (F),DM1,"Town of Peru 3 ",0,1,0,2,3,1.51
DELEGATES TO NATIONAL CONVENTION 21st Congressional District,Michele L. Hill-Davis (F),DM1,"Town of Peru 4 ",0,4,0,4,8,1.49
DELEGATES TO NATIONAL CONVENTION 21st Congressional District,Michele L. Hill-Davis (F),DM1,"Town of Plattsburgh 1 ",0,12,0,3,15,4.02
DELEGATES TO NATIONAL CONVENTION 21st Congressional District,Michele L. Hill-Davis (F),DM1,"Town of Plattsburgh 2 ",0,5,0,1,6,1.25
DELEGATES TO NATIONAL CONVENTION 21st Congressional District,Michele L. Hill-Davis (F),DM1,"Town of Plattsburgh 3 ",0,9,0,3,12,1.82
DELEGATES TO NATIONAL CONVENTION 21st Congressional District,Michele L. Hill-Davis (F),DM1,"Town of Plattsburgh 4 ",0,6,0,3,9,2.22
DELEGATES TO NATIONAL CONVENTION 21st Congressional District,Michele L. Hill-Davis (F),DM1,"Town of Plattsburgh 5 ",0,3,0,4,7,2.30
DELEGATES TO NATIONAL CONVENTION 21st Congressional District,Michele L. Hill-Davis (F),DM1,"Town of Plattsburgh 6 ",0,6,0,9,15,1.67
DELEGATES TO NATIONAL CONVENTION 21st Congressional District,Michele L. Hill-Davis (F),DM1,"Town of Plattsburgh 7 ",0,5,0,1,6,1.73
DELEGATES TO NATIONAL CONVENTION 21st Congressional District,Michele L. Hill-Davis (F),DM1,"Town of Saranac 1 ",0,6,0,2,8,1.83
DELEGATES TO NATIONAL CONVENTION 21st Congressional District,Michele L. Hill-Davis (F),DM1,"Town of Saranac 2 ",0,2,0,2,4,1.63
DELEGATES TO NATIONAL CONVENTION 21st Congressional District,Michele L. Hill-Davis (F),DM1,"Town of Saranac 3 ",0,2,0,3,5,2.40
DELEGATES TO NATIONAL CONVENTION 21st Congressional District,Michele L. Hill-Davis (F),DM1,"Town of Schuyler Falls 1 ",0,2,0,0,2,1.26
DELEGATES TO NATIONAL CONVENTION 21st Congressional District,Michele L. Hill-Davis (F),DM1,"Town of Schuyler Falls 2 ",0,12,0,1,13,2.88
DELEGATES TO NATIONAL CONVENTION 21st Congressional District,Michele L. Hill-Davis (F),DM1,"Town of Schuyler Falls 3 ",0,7,0,3,10,2.70
DELEGATES TO NATIONAL CONVENTION 21st Congressional District,Jeffrey M. Cox (M),DM1,"City of Plattsburgh Ward 1 1 ",0,0,0,1,1,0.56
DELEGATES TO NATIONAL CONVENTION 21st Congressional District,Jeffrey M. Cox (M),DM1,"City of Plattsburgh Ward 1 2 ",0,4,0,6,10,0.81
DELEGATES TO NATIONAL CONVENTION 21st Congressional District,Jeffrey M. Cox (M),DM1,"City of Plattsburgh Ward 1 3 ",0,0,0,0,0,0.00
DELEGATES TO NATIONAL CONVENTION 21st Congressional District,Jeffrey M. Cox (M),DM1,"City of Plattsburgh Ward 2 1 ",0,0,0,1,1,0.26
DELEGATES TO NATIONAL CONVENTION 21st Congressional District,Jeffrey M. Cox (M),DM1,"City of Plattsburgh Ward 2 2 ",0,1,0,2,3,1.22
DELEGATES TO NATIONAL CONVENTION 21st Congressional District,Jeffrey M. Cox (M),DM1,"City of Plattsburgh Ward 3 1 ",0,2,0,1,3,0.55
DELEGATES TO NATIONAL CONVENTION 21st Congressional District,Jeffrey M. Cox (M),DM1,"City of Plattsburgh Ward 3 2 ",0,3,0,3,6,0.71
DELEGATES TO NATIONAL CONVENTION 21st Congressional District,Jeffrey M. Cox (M),DM1,"City of Plattsburgh Ward 4 1 ",0,1,0,1,2,0.25
DELEGATES TO NATIONAL CONVENTION 21st Congressional District,Jeffrey M. Cox (M),DM1,"City of Plattsburgh Ward 4 2 ",0,4,0,2,6,0.75
DELEGATES TO NATIONAL CONVENTION 21st Congressional District,Jeffrey M. Cox (M),DM1,"City of Plattsburgh Ward 5 1 ",0,4,0,2,6,1.08
DELEGATES TO NATIONAL CONVENTION 21st Congressional District,Jeffrey M. Cox (M),DM1,"City of Plattsburgh Ward 5 2 ",0,2,0,0,2,0.25
DELEGATES TO NATIONAL CONVENTION 21st Congressional District,Jeffrey M. Cox (M),DM1,"City of Plattsburgh Ward 6 1 ",0,0,0,4,4,0.59
DELEGATES TO NATIONAL CONVENTION 21st Congressional District,Jeffrey M. Cox (M),DM1,"City of Plattsburgh Ward 6 2 ",0,0,0,1,1,0.30
DELEGATES TO NATIONAL CONVENTION 21st Congressional District,Jeffrey M. Cox (M),DM1,"Town of Altona 1 ",0,1,0,3,4,0.96
DELEGATES TO NATIONAL CONVENTION 21st Congressional District,Jeffrey M. Cox (M),DM1,"Town of AuSable 1 ",0,2,0,1,3,1.20
DELEGATES TO NATIONAL CONVENTION 21st Congressional District,Jeffrey M. Cox (M),DM1,"Town of AuSable 2 ",0,0,0,0,0,0.00
DELEGATES TO NATIONAL CONVENTION 21st Congressional District,Jeffrey M. Cox (M),DM1,"Town of Beekmantown 1 ",0,1,0,1,2,0.55
DELEGATES TO NATIONAL CONVENTION 21st Congressional District,Jeffrey M. Cox (M),DM1,"Town of Beekmantown 2 ",0,2,0,1,3,0.99
DELEGATES TO NATIONAL CONVENTION 21st Congressional District,Jeffrey M. Cox (M),DM1,"Town of Beekmantown 3 ",0,2,0,2,4,0.53
DELEGATES TO NATIONAL CONVENTION 21st Congressional District,Jeffrey M. Cox (M),DM1,"Town of Beekmantown 4 ",0,2,0,2,4,1.04
DELEGATES TO NATIONAL CONVENTION 21st Congressional District,Jeffrey M. Cox (M),DM1,"Town of Black Brook 1 ",0,0,0,0,0,0.00
DELEGATES TO NATIONAL CONVENTION 21st Congressional District,Jeffrey M. Cox (M),DM1,"Town of Black Brook 2 ",0,1,0,1,2,2.08
DELEGATES TO NATIONAL CONVENTION 21st Congressional District,Jeffrey M. Cox (M),DM1,"Town of Champlain 1 ",0,0,0,2,2,0.52
DELEGATES TO NATIONAL CONVENTION 21st Congressional District,Jeffrey M. Cox (M),DM1,"Town of Champlain 2 ",0,4,0,1,5,0.95
DELEGATES TO NATIONAL CONVENTION 21st Congressional District,Jeffrey M. Cox (M),DM1,"Town of Champlain 3 ",0,2,0,4,6,1.35
DELEGATES TO NATIONAL CONVENTION 21st Congressional District,Jeffrey M. Cox (M),DM1,"Town of Chazy 1 ",0,2,0,2,4,0.79
DELEGATES TO NATIONAL CONVENTION 21st Congressional District,Jeffrey M. Cox (M),DM1,"Town of Chazy 2 ",0,5,0,0,5,1.14
DELEGATES TO NATIONAL CONVENTION 21st Congressional District,Jeffrey M. Cox (M),DM1,"Town of Clinton 1 ",0,3,0,1,4,3.81
DELEGATES TO NATIONAL CONVENTION 21st Congressional District,Jeffrey M. Cox (M),DM1,"Town of Dannemora 1 ",0,0,0,1,1,1.25
DELEGATES TO NATIONAL CONVENTION 21st Congressional District,Jeffrey M. Cox (M),DM1,"Town of Dannemora 2 ",0,1,0,0,1,0.79
DELEGATES TO NATIONAL CONVENTION 21st Congressional District,Jeffrey M. Cox (M),DM1,"Town of Dannemora 3 ",0,0,0,3,3,1.63
DELEGATES TO NATIONAL CONVENTION 21st Congressional District,Jeffrey M. Cox (M),DM1,"Town of Ellenburg 1 ",0,3,0,4,7,1.97
DELEGATES TO NATIONAL CONVENTION 21st Congressional District,Jeffrey M. Cox (M),DM1,"Town of Mooers 1 ",0,5,0,1,6,1.79
DELEGATES TO NATIONAL CONVENTION 21st Congressional District,Jeffrey M. Cox (M),DM1,"Town of Mooers 2 ",0,0,0,2,2,1.43
DELEGATES TO NATIONAL CONVENTION 21st Congressional District,Jeffrey M. Cox (M),DM1,"Town of Peru 1 ",0,0,0,3,3,0.80
DELEGATES TO NATIONAL CONVENTION 21st Congressional District,Jeffrey M. Cox (M),DM1,"Town of Peru 2 ",0,3,0,4,7,1.28
DELEGATES TO NATIONAL CONVENTION 21st Congressional District,Jeffrey M. Cox (M),DM1,"Town of Peru 3 ",0,1,0,1,2,1.01
DELEGATES TO NATIONAL CONVENTION 21st Congressional District,Jeffrey M. Cox (M),DM1,"Town of Peru 4 ",0,3,0,0,3,0.56
DELEGATES TO NATIONAL CONVENTION 21st Congressional District,Jeffrey M. Cox (M),DM1,"Town of Plattsburgh 1 ",0,7,0,2,9,2.41
DELEGATES TO NATIONAL CONVENTION 21st Congressional District,Jeffrey M. Cox (M),DM1,"Town of Plattsburgh 2 ",0,2,0,0,2,0.42
DELEGATES TO NATIONAL CONVENTION 21st Congressional District,Jeffrey M. Cox (M),DM1,"Town of Plattsburgh 3 ",0,3,0,0,3,0.46
DELEGATES TO NATIONAL CONVENTION 21st Congressional District,Jeffrey M. Cox (M),DM1,"Town of Plattsburgh 4 ",0,3,0,2,5,1.23
DELEGATES TO NATIONAL CONVENTION 21st Congressional District,Jeffrey M. Cox (M),DM1,"Town of Plattsburgh 5 ",0,2,0,3,5,1.64
DELEGATES TO NATIONAL CONVENTION 21st Congressional District,Jeffrey M. Cox (M),DM1,"Town of Plattsburgh 6 ",0,3,0,1,4,0.44
DELEGATES TO NATIONAL CONVENTION 21st Congressional District,Jeffrey M. Cox (M),DM1,"Town of Plattsburgh 7 ",0,3,0,1,4,1.15
DELEGATES TO NATIONAL CONVENTION 21st Congressional District,Jeffrey M. Cox (M),DM1,"Town of Saranac 1 ",0,2,0,1,3,0.68
DELEGATES TO NATIONAL CONVENTION 21st Congressional District,Jeffrey M. Cox (M),DM1,"Town of Saranac 2 ",0,0,0,1,1,0.41
DELEGATES TO NATIONAL CONVENTION 21st Congressional District,Jeffrey M. Cox (M),DM1,"Town of Saranac 3 ",0,0,0,1,1,0.48
DELEGATES TO NATIONAL CONVENTION 21st Congressional District,Jeffrey M. Cox (M),DM1,"Town of Schuyler Falls 1 ",0,2,0,0,2,1.26
DELEGATES TO NATIONAL CONVENTION 21st Congressional District,Jeffrey M. Cox (M),DM1,"Town of Schuyler Falls 2 ",0,4,0,4,8,1.77
DELEGATES TO NATIONAL CONVENTION 21st Congressional District,Jeffrey M. Cox (M),DM1,"Town of Schuyler Falls 3 ",0,2,0,1,3,0.81
DELEGATES TO NATIONAL CONVENTION 21st Congressional District,June F. O'Neill (F),DM3,"City of Plattsburgh Ward 1 1 ",0,10,0,1,11,6.18
DELEGATES TO NATIONAL CONVENTION 21st Congressional District,June F. O'Neill (F),DM3,"City of Plattsburgh Ward 1 2 ",0,92,0,25,117,9.45
DELEGATES TO NATIONAL CONVENTION 21st Congressional District,June F. O'Neill (F),DM3,"City of Plattsburgh Ward 1 3 ",0,3,0,0,3,8.33
DELEGATES TO NATIONAL CONVENTION 21st Congressional District,June F. O'Neill (F),DM3,"City of Plattsburgh Ward 2 1 ",0,23,0,10,33,8.48
DELEGATES TO NATIONAL CONVENTION 21st Congressional District,June F. O'Neill (F),DM3,"City of Plattsburgh Ward 2 2 ",0,9,0,5,14,5.71
DELEGATES TO NATIONAL CONVENTION 21st Congressional District,June F. O'Neill (F),DM3,"City of Plattsburgh Ward 3 1 ",0,40,0,11,51,9.29
DELEGATES TO NATIONAL CONVENTION 21st Congressional District,June F. O'Neill (F),DM3,"City of Plattsburgh Ward 3 2 ",0,51,0,23,74,8.75
DELEGATES TO NATIONAL CONVENTION 21st Congressional District,June F. O'Neill (F),DM3,"City of Plattsburgh Ward 4 1 ",0,46,0,25,71,8.81
DELEGATES TO NATIONAL CONVENTION 21st Congressional District,June F. O'Neill (F),DM3,"City of Plattsburgh Ward 4 2 ",0,58,0,18,76,9.51
DELEGATES TO NATIONAL CONVENTION 21st Congressional District,June F. O'Neill (F),DM3,"City of Plattsburgh Ward 5 1 ",0,33,0,11,44,7.91
DELEGATES TO NATIONAL CONVENTION 21st Congressional District,June F. O'Neill (F),DM3,"City of Plattsburgh Ward 5 2 ",0,52,0,16,68,8.46
DELEGATES TO NATIONAL CONVENTION 21st Congressional District,June F. O'Neill (F),DM3,"City of Plattsburgh Ward 6 1 ",0,44,0,11,55,8.15
DELEGATES TO NATIONAL CONVENTION 21st Congressional District,June F. O'Neill (F),DM3,"City of Plattsburgh Ward 6 2 ",0,9,0,7,16,4.88
DELEGATES TO NATIONAL CONVENTION 21st Congressional District,June F. O'Neill (F),DM3,"Town of Altona 1 ",0,16,0,8,24,5.78
DELEGATES TO NATIONAL CONVENTION 21st Congressional District,June F. O'Neill (F),DM3,"Town of AuSable 1 ",0,12,0,9,21,8.43
DELEGATES TO NATIONAL CONVENTION 21st Congressional District,June F. O'Neill (F),DM3,"Town of AuSable 2 ",0,17,0,6,23,8.65
DELEGATES TO NATIONAL CONVENTION 21st Congressional District,June F. O'Neill (F),DM3,"Town of Beekmantown 1 ",0,21,0,15,36,9.94
DELEGATES TO NATIONAL CONVENTION 21st Congressional District,June F. O'Neill (F),DM3,"Town of Beekmantown 2 ",0,23,0,6,29,9.54
DELEGATES TO NATIONAL CONVENTION 21st Congressional District,June F. O'Neill (F),DM3,"Town of Beekmantown 3 ",0,64,0,16,80,10.70
DELEGATES TO NATIONAL CONVENTION 21st Congressional District,June F. O'Neill (F),DM3,"Town of Beekmantown 4 ",0,28,0,13,41,10.65
DELEGATES TO NATIONAL CONVENTION 21st Congressional District,June F. O'Neill (F),DM3,"Town of Black Brook 1 ",0,23,0,6,29,10.78
DELEGATES TO NATIONAL CONVENTION 21st Congressional District,June F. O'Neill (F),DM3,"Town of Black Brook 2 ",0,5,0,3,8,8.33
DELEGATES TO NATIONAL CONVENTION 21st Congressional District,June F. O'Neill (F),DM3,"Town of Champlain 1 ",0,28,0,7,35,9.07
DELEGATES TO NATIONAL CONVENTION 21st Congressional District,June F. O'Neill (F),DM3,"Town of Champlain 2 ",0,35,0,10,45,8.51
DELEGATES TO NATIONAL CONVENTION 21st Congressional District,June F. O'Neill (F),DM3,"Town of Champlain 3 ",0,33,0,5,38,8.52
DELEGATES TO NATIONAL CONVENTION 21st Congressional District,June F. O'Neill (F),DM3,"Town of Chazy 1 ",0,43,0,8,51,10.02
DELEGATES TO NATIONAL CONVENTION 21st Congressional District,June F. O'Neill (F),DM3,"Town of Chazy 2 ",0,31,0,5,36,8.18
DELEGATES TO NATIONAL CONVENTION 21st Congressional District,June F. O'Neill (F),DM3,"Town of Clinton 1 ",0,9,0,2,11,10.48
DELEGATES TO NATIONAL CONVENTION 21st Congressional District,June F. O'Neill (F),DM3,"Town of Dannemora 1 ",0,4,0,3,7,8.75
DELEGATES TO NATIONAL CONVENTION 21st Congressional District,June F. O'Neill (F),DM3,"Town of Dannemora 2 ",0,10,0,3,13,10.32
DELEGATES TO NATIONAL CONVENTION 21st Congressional District,June F. O'Neill (F),DM3,"Town of Dannemora 3 ",0,15,0,7,22,11.96
DELEGATES TO NATIONAL CONVENTION 21st Congressional District,June F. O'Neill (F),DM3,"Town of Ellenburg 1 ",0,32,0,8,40,11.27
DELEGATES TO NATIONAL CONVENTION 21st Congressional District,June F. O'Neill (F),DM3,"Town of Mooers 1 ",0,14,0,6,20,5.97
DELEGATES TO NATIONAL CONVENTION 21st Congressional District,June F. O'Neill (F),DM3,"Town of Mooers 2 ",0,15,0,0,15,10.71
DELEGATES TO NATIONAL CONVENTION 21st Congressional District,June F. O'Neill (F),DM3,"Town of Peru 1 ",0,26,0,6,32,8.58
DELEGATES TO NATIONAL CONVENTION 21st Congressional District,June F. O'Neill (F),DM3,"Town of Peru 2 ",0,41,0,9,50,9.16
DELEGATES TO NATIONAL CONVENTION 21st Congressional District,June F. O'Neill (F),DM3,"Town of Peru 3 ",0,13,0,1,14,7.04
DELEGATES TO NATIONAL CONVENTION 21st Congressional District,June F. O'Neill (F),DM3,"Town of Peru 4 ",0,46,0,7,53,9.85
DELEGATES TO NATIONAL CONVENTION 21st Congressional District,June F. O'Neill (F),DM3,"Town of Plattsburgh 1 ",0,25,0,7,32,8.58
DELEGATES TO NATIONAL CONVENTION 21st Congressional District,June F. O'Neill (F),DM3,"Town of Plattsburgh 2 ",0,43,0,9,52,10.81
DELEGATES TO NATIONAL CONVENTION 21st Congressional District,June F. O'Neill (F),DM3,"Town of Plattsburgh 3 ",0,36,0,26,62,9.42
DELEGATES TO NATIONAL CONVENTION 21st Congressional District,June F. O'Neill (F),DM3,"Town of Plattsburgh 4 ",0,37,0,4,41,10.12
DELEGATES TO NATIONAL CONVENTION 21st Congressional District,June F. O'Neill (F),DM3,"Town of Plattsburgh 5 ",0,15,0,11,26,8.52
DELEGATES TO NATIONAL CONVENTION 21st Congressional District,June F. O'Neill (F),DM3,"Town of Plattsburgh 6 ",0,72,0,18,90,10.00
DELEGATES TO NATIONAL CONVENTION 21st Congressional District,June F. O'Neill (F),DM3,"Town of Plattsburgh 7 ",0,24,0,2,26,7.49
DELEGATES TO NATIONAL CONVENTION 21st Congressional District,June F. O'Neill (F),DM3,"Town of Saranac 1 ",0,37,0,6,43,9.82
DELEGATES TO NATIONAL CONVENTION 21st Congressional District,June F. O'Neill (F),DM3,"Town of Saranac 2 ",0,15,0,4,19,7.72
DELEGATES TO NATIONAL CONVENTION 21st Congressional District,June F. O'Neill (F),DM3,"Town of Saranac 3 ",0,13,0,6,19,9.13
DELEGATES TO NATIONAL CONVENTION 21st Congressional District,June F. O'Neill (F),DM3,"Town of Schuyler Falls 1 ",0,15,0,0,15,9.43
DELEGATES TO NATIONAL CONVENTION 21st Congressional District,June F. O'Neill (F),DM3,"Town of Schuyler Falls 2 ",0,28,0,5,33,7.30
DELEGATES TO NATIONAL CONVENTION 21st Congressional District,June F. O'Neill (F),DM3,"Town of Schuyler Falls 3 ",0,33,0,3,36,9.70
DELEGATES TO NATIONAL CONVENTION 21st Congressional District,Ronald P. McDougall (M),DM3,"City of Plattsburgh Ward 1 1 ",0,6,0,1,7,3.93
DELEGATES TO NATIONAL CONVENTION 21st Congressional District,Ronald P. McDougall (M),DM3,"City of Plattsburgh Ward 1 2 ",0,85,0,25,110,8.89
DELEGATES TO NATIONAL CONVENTION 21st Congressional District,Ronald P. McDougall (M),DM3,"City of Plattsburgh Ward 1 3 ",0,1,0,0,1,2.78
DELEGATES TO NATIONAL CONVENTION 21st Congressional District,Ronald P. McDougall (M),DM3,"City of Plattsburgh Ward 2 1 ",0,22,0,7,29,7.46
DELEGATES TO NATIONAL CONVENTION 21st Congressional District,Ronald P. McDougall (M),DM3,"City of Plattsburgh Ward 2 2 ",0,8,0,5,13,5.31
DELEGATES TO NATIONAL CONVENTION 21st Congressional District,Ronald P. McDougall (M),DM3,"City of Plattsburgh Ward 3 1 ",0,40,0,9,49,8.93
DELEGATES TO NATIONAL CONVENTION 21st Congressional District,Ronald P. McDougall (M),DM3,"City of Plattsburgh Ward 3 2 ",0,40,0,18,58,6.86
DELEGATES TO NATIONAL CONVENTION 21st Congressional District,Ronald P. McDougall (M),DM3,"City of Plattsburgh Ward 4 1 ",0,41,0,19,60,7.44
DELEGATES TO NATIONAL CONVENTION 21st Congressional District,Ronald P. McDougall (M),DM3,"City of Plattsburgh Ward 4 2 ",0,50,0,17,67,8.39
DELEGATES TO NATIONAL CONVENTION 21st Congressional District,Ronald P. McDougall (M),DM3,"City of Plattsburgh Ward 5 1 ",0,24,0,11,35,6.29
DELEGATES TO NATIONAL CONVENTION 21st Congressional District,Ronald P. McDougall (M),DM3,"City of Plattsburgh Ward 5 2 ",0,49,0,14,63,7.84
DELEGATES TO NATIONAL CONVENTION 21st Congressional District,Ronald P. McDougall (M),DM3,"City of Plattsburgh Ward 6 1 ",0,37,0,8,45,6.67
DELEGATES TO NATIONAL CONVENTION 21st Congressional District,Ronald P. McDougall (M),DM3,"City of Plattsburgh Ward 6 2 ",0,6,0,5,11,3.35
DELEGATES TO NATIONAL CONVENTION 21st Congressional District,Ronald P. McDougall (M),DM3,"Town of Altona 1 ",0,14,0,9,23,5.54
DELEGATES TO NATIONAL CONVENTION 21st Congressional District,Ronald P. McDougall (M),DM3,"Town of AuSable 1 ",0,10,0,7,17,6.83
DELEGATES TO NATIONAL CONVENTION 21st Congressional District,Ronald P. McDougall (M),DM3,"Town of AuSable 2 ",0,18,0,4,22,8.27
DELEGATES TO NATIONAL CONVENTION 21st Congressional District,Ronald P. McDougall (M),DM3,"Town of Beekmantown 1 ",0,19,0,12,31,8.56
DELEGATES TO NATIONAL CONVENTION 21st Congressional District,Ronald P. McDougall (M),DM3,"Town of Beekmantown 2 ",0,19,0,3,22,7.24
DELEGATES TO NATIONAL CONVENTION 21st Congressional District,Ronald P. McDougall (M),DM3,"Town of Beekmantown 3 ",0,56,0,20,76,10.16
DELEGATES TO NATIONAL CONVENTION 21st Congressional District,Ronald P. McDougall (M),DM3,"Town of Beekmantown 4 ",0,28,0,12,40,10.39
DELEGATES TO NATIONAL CONVENTION 21st Congressional District,Ronald P. McDougall (M),DM3,"Town of Black Brook 1 ",0,24,0,6,30,11.15
DELEGATES TO NATIONAL CONVENTION 21st Congressional District,Ronald P. McDougall (M),DM3,"Town of Black Brook 2 ",0,5,0,4,9,9.38
DELEGATES TO NATIONAL CONVENTION 21st Congressional District,Ronald P. McDougall (M),DM3,"Town of Champlain 1 ",0,31,0,8,39,10.10
DELEGATES TO NATIONAL CONVENTION 21st Congressional District,Ronald P. McDougall (M),DM3,"Town of Champlain 2 ",0,36,0,9,45,8.51
DELEGATES TO NATIONAL CONVENTION 21st Congressional District,Ronald P. McDougall (M),DM3,"Town of Champlain 3 ",0,32,0,4,36,8.07
DELEGATES TO NATIONAL CONVENTION 21st Congressional District,Ronald P. McDougall (M),DM3,"Town of Chazy 1 ",0,40,0,7,47,9.23
DELEGATES TO NATIONAL CONVENTION 21st Congressional District,Ronald P. McDougall (M),DM3,"Town of Chazy 2 ",0,20,0,7,27,6.14
DELEGATES TO NATIONAL CONVENTION 21st Congressional District,Ronald P. McDougall (M),DM3,"Town of Clinton 1 ",0,6,0,0,6,5.71
DELEGATES TO NATIONAL CONVENTION 21st Congressional District,Ronald P. McDougall (M),DM3,"Town of Dannemora 1 ",0,4,0,4,8,10.00
DELEGATES TO NATIONAL CONVENTION 21st Congressional District,Ronald P. McDougall (M),DM3,"Town of Dannemora 2 ",0,8,0,3,11,8.73
DELEGATES TO NATIONAL CONVENTION 21st Congressional District,Ronald P. McDougall (M),DM3,"Town of Dannemora 3 ",0,12,0,3,15,8.15
DELEGATES TO NATIONAL CONVENTION 21st Congressional District,Ronald P. McDougall (M),DM3,"Town of Ellenburg 1 ",0,27,0,3,30,8.45
DELEGATES TO NATIONAL CONVENTION 21st Congressional District,Ronald P. McDougall (M),DM3,"Town of Mooers 1 ",0,16,0,7,23,6.87
DELEGATES TO NATIONAL CONVENTION 21st Congressional District,Ronald P. McDougall (M),DM3,"Town of Mooers 2 ",0,15,0,0,15,10.71
DELEGATES TO NATIONAL CONVENTION 21st Congressional District,Ronald P. McDougall (M),DM3,"Town of Peru 1 ",0,26,0,6,32,8.58
DELEGATES TO NATIONAL CONVENTION 21st Congressional District,Ronald P. McDougall (M),DM3,"Town of Peru 2 ",0,28,0,3,31,5.68
DELEGATES TO NATIONAL CONVENTION 21st Congressional District,Ronald P. McDougall (M),DM3,"Town of Peru 3 ",0,11,0,2,13,6.53
DELEGATES TO NATIONAL CONVENTION 21st Congressional District,Ronald P. McDougall (M),DM3,"Town of Peru 4 ",0,38,0,6,44,8.18
DELEGATES TO NATIONAL CONVENTION 21st Congressional District,Ronald P. McDougall (M),DM3,"Town of Plattsburgh 1 ",0,20,0,6,26,6.97
DELEGATES TO NATIONAL CONVENTION 21st Congressional District,Ronald P. McDougall (M),DM3,"Town of Plattsburgh 2 ",0,38,0,7,45,9.36
DELEGATES TO NATIONAL CONVENTION 21st Congressional District,Ronald P. McDougall (M),DM3,"Town of Plattsburgh 3 ",0,34,0,20,54,8.21
DELEGATES TO NATIONAL CONVENTION 21st Congressional District,Ronald P. McDougall (M),DM3,"Town of Plattsburgh 4 ",0,30,0,6,36,8.89
DELEGATES TO NATIONAL CONVENTION 21st Congressional District,Ronald P. McDougall (M),DM3,"Town of Plattsburgh 5 ",0,9,0,6,15,4.92
DELEGATES TO NATIONAL CONVENTION 21st Congressional District,Ronald P. McDougall (M),DM3,"Town of Plattsburgh 6 ",0,62,0,13,75,8.33
DELEGATES TO NATIONAL CONVENTION 21st Congressional District,Ronald P. McDougall (M),DM3,"Town of Plattsburgh 7 ",0,22,0,1,23,6.63
DELEGATES TO NATIONAL CONVENTION 21st Congressional District,Ronald P. McDougall (M),DM3,"Town of Saranac 1 ",0,33,0,5,38,8.68
DELEGATES TO NATIONAL CONVENTION 21st Congressional District,Ronald P. McDougall (M),DM3,"Town of Saranac 2 ",0,16,0,6,22,8.94
DELEGATES TO NATIONAL CONVENTION 21st Congressional District,Ronald P. McDougall (M),DM3,"Town of Saranac 3 ",0,11,0,4,15,7.21
DELEGATES TO NATIONAL CONVENTION 21st Congressional District,Ronald P. McDougall (M),DM3,"Town of Schuyler Falls 1 ",0,10,0,2,12,7.55
DELEGATES TO NATIONAL CONVENTION 21st Congressional District,Ronald P. McDougall (M),DM3,"Town of Schuyler Falls 2 ",0,24,0,9,33,7.30
DELEGATES TO NATIONAL CONVENTION 21st Congressional District,Ronald P. McDougall (M),DM3,"Town of Schuyler Falls 3 ",0,31,0,0,31,8.36
DELEGATES TO NATIONAL CONVENTION 21st Congressional District,Lynne C. Boecher (F),DM3,"City of Plattsburgh Ward 1 1 ",0,10,0,1,11,6.18
DELEGATES TO NATIONAL CONVENTION 21st Congressional District,Lynne C. Boecher (F),DM3,"City of Plattsburgh Ward 1 2 ",0,92,0,24,116,9.37
DELEGATES TO NATIONAL CONVENTION 21st Congressional District,Lynne C. Boecher (F),DM3,"City of Plattsburgh Ward 1 3 ",0,3,0,0,3,8.33
DELEGATES TO NATIONAL CONVENTION 21st Congressional District,Lynne C. Boecher (F),DM3,"City of Plattsburgh Ward 2 1 ",0,22,0,7,29,7.46
DELEGATES TO NATIONAL CONVENTION 21st Congressional District,Lynne C. Boecher (F),DM3,"City of Plattsburgh Ward 2 2 ",0,9,0,4,13,5.31
DELEGATES TO NATIONAL CONVENTION 21st Congressional District,Lynne C. Boecher (F),DM3,"City of Plattsburgh Ward 3 1 ",0,35,0,6,41,7.47
DELEGATES TO NATIONAL CONVENTION 21st Congressional District,Lynne C. Boecher (F),DM3,"City of Plattsburgh Ward 3 2 ",0,52,0,25,77,9.10
DELEGATES TO NATIONAL CONVENTION 21st Congressional District,Lynne C. Boecher (F),DM3,"City of Plattsburgh Ward 4 1 ",0,41,0,23,64,7.94
DELEGATES TO NATIONAL CONVENTION 21st Congressional District,Lynne C. Boecher (F),DM3,"City of Plattsburgh Ward 4 2 ",0,57,0,19,76,9.51
DELEGATES TO NATIONAL CONVENTION 21st Congressional District,Lynne C. Boecher (F),DM3,"City of Plattsburgh Ward 5 1 ",0,27,0,10,37,6.65
DELEGATES TO NATIONAL CONVENTION 21st Congressional District,Lynne C. Boecher (F),DM3,"City of Plattsburgh Ward 5 2 ",0,52,0,15,67,8.33
DELEGATES TO NATIONAL CONVENTION 21st Congressional District,Lynne C. Boecher (F),DM3,"City of Plattsburgh Ward 6 1 ",0,45,0,8,53,7.85
DELEGATES TO NATIONAL CONVENTION 21st Congressional District,Lynne C. Boecher (F),DM3,"City of Plattsburgh Ward 6 2 ",0,11,0,10,21,6.40
DELEGATES TO NATIONAL CONVENTION 21st Congressional District,Lynne C. Boecher (F),DM3,"Town of Altona 1 ",0,19,0,9,28,6.75
DELEGATES TO NATIONAL CONVENTION 21st Congressional District,Lynne C. Boecher (F),DM3,"Town of AuSable 1 ",0,11,0,8,19,7.63
DELEGATES TO NATIONAL CONVENTION 21st Congressional District,Lynne C. Boecher (F),DM3,"Town of AuSable 2 ",0,18,0,4,22,8.27
DELEGATES TO NATIONAL CONVENTION 21st Congressional District,Lynne C. Boecher (F),DM3,"Town of Beekmantown 1 ",0,16,0,16,32,8.84
DELEGATES TO NATIONAL CONVENTION 21st Congressional District,Lynne C. Boecher (F),DM3,"Town of Beekmantown 2 ",0,22,0,4,26,8.55
DELEGATES TO NATIONAL CONVENTION 21st Congressional District,Lynne C. Boecher (F),DM3,"Town of Beekmantown 3 ",0,58,0,17,75,10.03
DELEGATES TO NATIONAL CONVENTION 21st Congressional District,Lynne C. Boecher (F),DM3,"Town of Beekmantown 4 ",0,30,0,12,42,10.91
DELEGATES TO NATIONAL CONVENTION 21st Congressional District,Lynne C. Boecher (F),DM3,"Town of Black Brook 1 ",0,25,0,6,31,11.52
DELEGATES TO NATIONAL CONVENTION 21st Congressional District,Lynne C. Boecher (F),DM3,"Town of Black Brook 2 ",0,4,0,3,7,7.29
DELEGATES TO NATIONAL CONVENTION 21st Congressional District,Lynne C. Boecher (F),DM3,"Town of Champlain 1 ",0,25,0,7,32,8.29
DELEGATES TO NATIONAL CONVENTION 21st Congressional District,Lynne C. Boecher (F),DM3,"Town of Champlain 2 ",0,36,0,11,47,8.88
DELEGATES TO NATIONAL CONVENTION 21st Congressional District,Lynne C. Boecher (F),DM3,"Town of Champlain 3 ",0,31,0,6,37,8.30
DELEGATES TO NATIONAL CONVENTION 21st Congressional District,Lynne C. Boecher (F),DM3,"Town of Chazy 1 ",0,45,0,8,53,10.41
DELEGATES TO NATIONAL CONVENTION 21st Congressional District,Lynne C. Boecher (F),DM3,"Town of Chazy 2 ",0,21,0,7,28,6.36
DELEGATES TO NATIONAL CONVENTION 21st Congressional District,Lynne C. Boecher (F),DM3,"Town of Clinton 1 ",0,5,0,0,5,4.76
DELEGATES TO NATIONAL CONVENTION 21st Congressional District,Lynne C. Boecher (F),DM3,"Town of Dannemora 1 ",0,4,0,4,8,10.00
DELEGATES TO NATIONAL CONVENTION 21st Congressional District,Lynne C. Boecher (F),DM3,"Town of Dannemora 2 ",0,10,0,2,12,9.52
DELEGATES TO NATIONAL CONVENTION 21st Congressional District,Lynne C. Boecher (F),DM3,"Town of Dannemora 3 ",0,13,0,5,18,9.78
DELEGATES TO NATIONAL CONVENTION 21st Congressional District,Lynne C. Boecher (F),DM3,"Town of Ellenburg 1 ",0,27,0,4,31,8.73
DELEGATES TO NATIONAL CONVENTION 21st Congressional District,Lynne C. Boecher (F),DM3,"Town of Mooers 1 ",0,19,0,8,27,8.06
DELEGATES TO NATIONAL CONVENTION 21st Congressional District,Lynne C. Boecher (F),DM3,"Town of Mooers 2 ",0,15,0,0,15,10.71
DELEGATES TO NATIONAL CONVENTION 21st Congressional District,Lynne C. Boecher (F),DM3,"Town of Peru 1 ",0,30,0,6,36,9.65
DELEGATES TO NATIONAL CONVENTION 21st Congressional District,Lynne C. Boecher (F),DM3,"Town of Peru 2 ",0,33,0,4,37,6.78
DELEGATES TO NATIONAL CONVENTION 21st Congressional District,Lynne C. Boecher (F),DM3,"Town of Peru 3 ",0,17,0,1,18,9.05
DELEGATES TO NATIONAL CONVENTION 21st Congressional District,Lynne C. Boecher (F),DM3,"Town of Peru 4 ",0,42,0,4,46,8.55
DELEGATES TO NATIONAL CONVENTION 21st Congressional District,Lynne C. Boecher (F),DM3,"Town of Plattsburgh 1 ",0,23,0,4,27,7.24
DELEGATES TO NATIONAL CONVENTION 21st Congressional District,Lynne C. Boecher (F),DM3,"Town of Plattsburgh 2 ",0,41,0,5,46,9.56
DELEGATES TO NATIONAL CONVENTION 21st Congressional District,Lynne C. Boecher (F),DM3,"Town of Plattsburgh 3 ",0,30,0,28,58,8.81
DELEGATES TO NATIONAL CONVENTION 21st Congressional District,Lynne C. Boecher (F),DM3,"Town of Plattsburgh 4 ",0,29,0,4,33,8.15
DELEGATES TO NATIONAL CONVENTION 21st Congressional District,Lynne C. Boecher (F),DM3,"Town of Plattsburgh 5 ",0,15,0,8,23,7.54
DELEGATES TO NATIONAL CONVENTION 21st Congressional District,Lynne C. Boecher (F),DM3,"Town of Plattsburgh 6 ",0,70,0,15,85,9.44
DELEGATES TO NATIONAL CONVENTION 21st Congressional District,Lynne C. Boecher (F),DM3,"Town of Plattsburgh 7 ",0,23,0,2,25,7.20
DELEGATES TO NATIONAL CONVENTION 21st Congressional District,Lynne C. Boecher (F),DM3,"Town of Saranac 1 ",0,34,0,6,40,9.13
DELEGATES TO NATIONAL CONVENTION 21st Congressional District,Lynne C. Boecher (F),DM3,"Town of Saranac 2 ",0,14,0,8,22,8.94
DELEGATES TO NATIONAL CONVENTION 21st Congressional District,Lynne C. Boecher (F),DM3,"Town of Saranac 3 ",0,16,0,3,19,9.13
DELEGATES TO NATIONAL CONVENTION 21st Congressional District,Lynne C. Boecher (F),DM3,"Town of Schuyler Falls 1 ",0,10,0,1,11,6.92
DELEGATES TO NATIONAL CONVENTION 21st Congressional District,Lynne C. Boecher (F),DM3,"Town of Schuyler Falls 2 ",0,31,0,6,37,8.19
DELEGATES TO NATIONAL CONVENTION 21st Congressional District,Lynne C. Boecher (F),DM3,"Town of Schuyler Falls 3 ",0,33,0,3,36,9.70
DELEGATES TO NATIONAL CONVENTION 21st Congressional District,Michael J. Zagrobelny (M),DM3,"City of Plattsburgh Ward 1 1 ",0,7,0,1,8,4.49
DELEGATES TO NATIONAL CONVENTION 21st Congressional District,Michael J. Zagrobelny (M),DM3,"City of Plattsburgh Ward 1 2 ",0,87,0,23,110,8.89
DELEGATES TO NATIONAL CONVENTION 21st Congressional District,Michael J. Zagrobelny (M),DM3,"City of Plattsburgh Ward 1 3 ",0,1,0,0,1,2.78
DELEGATES TO NATIONAL CONVENTION 21st Congressional District,Michael J. Zagrobelny (M),DM3,"City of Plattsburgh Ward 2 1 ",0,22,0,7,29,7.46
DELEGATES TO NATIONAL CONVENTION 21st Congressional District,Michael J. Zagrobelny (M),DM3,"City of Plattsburgh Ward 2 2 ",0,7,0,3,10,4.08
DELEGATES TO NATIONAL CONVENTION 21st Congressional District,Michael J. Zagrobelny (M),DM3,"City of Plattsburgh Ward 3 1 ",0,36,0,8,44,8.01
DELEGATES TO NATIONAL CONVENTION 21st Congressional District,Michael J. Zagrobelny (M),DM3,"City of Plattsburgh Ward 3 2 ",0,41,0,18,59,6.97
DELEGATES TO NATIONAL CONVENTION 21st Congressional District,Michael J. Zagrobelny (M),DM3,"City of Plattsburgh Ward 4 1 ",0,38,0,17,55,6.82
DELEGATES TO NATIONAL CONVENTION 21st Congressional District,Michael J. Zagrobelny (M),DM3,"City of Plattsburgh Ward 4 2 ",0,49,0,16,65,8.14
DELEGATES TO NATIONAL CONVENTION 21st Congressional District,Michael J. Zagrobelny (M),DM3,"City of Plattsburgh Ward 5 1 ",0,24,0,8,32,5.76
DELEGATES TO NATIONAL CONVENTION 21st Congressional District,Michael J. Zagrobelny (M),DM3,"City of Plattsburgh Ward 5 2 ",0,45,0,14,59,7.34
DELEGATES TO NATIONAL CONVENTION 21st Congressional District,Michael J. Zagrobelny (M),DM3,"City of Plattsburgh Ward 6 1 ",0,37,0,6,43,6.37
DELEGATES TO NATIONAL CONVENTION 21st Congressional District,Michael J. Zagrobelny (M),DM3,"City of Plattsburgh Ward 6 2 ",0,7,0,4,11,3.35
DELEGATES TO NATIONAL CONVENTION 21st Congressional District,Michael J. Zagrobelny (M),DM3,"Town of Altona 1 ",0,19,0,7,26,6.27
DELEGATES TO NATIONAL CONVENTION 21st Congressional District,Michael J. Zagrobelny (M),DM3,"Town of AuSable 1 ",0,9,0,5,14,5.62
DELEGATES TO NATIONAL CONVENTION 21st Congressional District,Michael J. Zagrobelny (M),DM3,"Town of AuSable 2 ",0,14,0,3,17,6.39
DELEGATES TO NATIONAL CONVENTION 21st Congressional District,Michael J. Zagrobelny (M),DM3,"Town of Beekmantown 1 ",0,17,0,12,29,8.01
DELEGATES TO NATIONAL CONVENTION 21st Congressional District,Michael J. Zagrobelny (M),DM3,"Town of Beekmantown 2 ",0,19,0,4,23,7.57
DELEGATES TO NATIONAL CONVENTION 21st Congressional District,Michael J. Zagrobelny (M),DM3,"Town of Beekmantown 3 ",0,52,0,15,67,8.96
DELEGATES TO NATIONAL CONVENTION 21st Congressional District,Michael J. Zagrobelny (M),DM3,"Town of Beekmantown 4 ",0,28,0,10,38,9.87
DELEGATES TO NATIONAL CONVENTION 21st Congressional District,Michael J. Zagrobelny (M),DM3,"Town of Black Brook 1 ",0,24,0,7,31,11.52
DELEGATES TO NATIONAL CONVENTION 21st Congressional District,Michael J. Zagrobelny (M),DM3,"Town of Black Brook 2 ",0,4,0,3,7,7.29
DELEGATES TO NATIONAL CONVENTION 21st Congressional District,Michael J. Zagrobelny (M),DM3,"Town of Champlain 1 ",0,22,0,5,27,6.99
DELEGATES TO NATIONAL CONVENTION 21st Congressional District,Michael J. Zagrobelny (M),DM3,"Town of Champlain 2 ",0,34,0,9,43,8.13
DELEGATES TO NATIONAL CONVENTION 21st Congressional District,Michael J. Zagrobelny (M),DM3,"Town of Champlain 3 ",0,30,0,4,34,7.62
DELEGATES TO NATIONAL CONVENTION 21st Congressional District,Michael J. Zagrobelny (M),DM3,"Town of Chazy 1 ",0,37,0,8,45,8.84
DELEGATES TO NATIONAL CONVENTION 21st Congressional District,Michael J. Zagrobelny (M),DM3,"Town of Chazy 2 ",0,18,0,4,22,5.00
DELEGATES TO NATIONAL CONVENTION 21st Congressional District,Michael J. Zagrobelny (M),DM3,"Town of Clinton 1 ",0,4,0,0,4,3.81
DELEGATES TO NATIONAL CONVENTION 21st Congressional District,Michael J. Zagrobelny (M),DM3,"Town of Dannemora 1 ",0,4,0,3,7,8.75
DELEGATES TO NATIONAL CONVENTION 21st Congressional District,Michael J. Zagrobelny (M),DM3,"Town of Dannemora 2 ",0,7,0,2,9,7.14
DELEGATES TO NATIONAL CONVENTION 21st Congressional District,Michael J. Zagrobelny (M),DM3,"Town of Dannemora 3 ",0,12,0,1,13,7.07
DELEGATES TO NATIONAL CONVENTION 21st Congressional District,Michael J. Zagrobelny (M),DM3,"Town of Ellenburg 1 ",0,25,0,6,31,8.73
DELEGATES TO NATIONAL CONVENTION 21st Congressional District,Michael J. Zagrobelny (M),DM3,"Town of Mooers 1 ",0,17,0,5,22,6.57
DELEGATES TO NATIONAL CONVENTION 21st Congressional District,Michael J. Zagrobelny (M),DM3,"Town of Mooers 2 ",0,15,0,0,15,10.71
DELEGATES TO NATIONAL CONVENTION 21st Congressional District,Michael J. Zagrobelny (M),DM3,"Town of Peru 1 ",0,24,0,4,28,7.51
DELEGATES TO NATIONAL CONVENTION 21st Congressional District,Michael J. Zagrobelny (M),DM3,"Town of Peru 2 ",0,26,0,6,32,5.86
DELEGATES TO NATIONAL CONVENTION 21st Congressional District,Michael J. Zagrobelny (M),DM3,"Town of Peru 3 ",0,11,0,1,12,6.03
DELEGATES TO NATIONAL CONVENTION 21st Congressional District,Michael J. Zagrobelny (M),DM3,"Town of Peru 4 ",0,35,0,6,41,7.62
DELEGATES TO NATIONAL CONVENTION 21st Congressional District,Michael J. Zagrobelny (M),DM3,"Town of Plattsburgh 1 ",0,21,0,3,24,6.43
DELEGATES TO NATIONAL CONVENTION 21st Congressional District,Michael J. Zagrobelny (M),DM3,"Town of Plattsburgh 2 ",0,37,0,6,43,8.94
DELEGATES TO NATIONAL CONVENTION 21st Congressional District,Michael J. Zagrobelny (M),DM3,"Town of Plattsburgh 3 ",0,32,0,19,51,7.75
DELEGATES TO NATIONAL CONVENTION 21st Congressional District,Michael J. Zagrobelny (M),DM3,"Town of Plattsburgh 4 ",0,29,0,2,31,7.65
DELEGATES TO NATIONAL CONVENTION 21st Congressional District,Michael J. Zagrobelny (M),DM3,"Town of Plattsburgh 5 ",0,14,0,3,17,5.57
DELEGATES TO NATIONAL CONVENTION 21st Congressional District,Michael J. Zagrobelny (M),DM3,"Town of Plattsburgh 6 ",0,61,0,11,72,8.00
DELEGATES TO NATIONAL CONVENTION 21st Congressional District,Michael J. Zagrobelny (M),DM3,"Town of Plattsburgh 7 ",0,22,0,2,24,6.92
DELEGATES TO NATIONAL CONVENTION 21st Congressional District,Michael J. Zagrobelny (M),DM3,"Town of Saranac 1 ",0,30,0,4,34,7.76
DELEGATES TO NATIONAL CONVENTION 21st Congressional District,Michael J. Zagrobelny (M),DM3,"Town of Saranac 2 ",0,16,0,5,21,8.54
DELEGATES TO NATIONAL CONVENTION 21st Congressional District,Michael J. Zagrobelny (M),DM3,"Town of Saranac 3 ",0,11,0,4,15,7.21
DELEGATES TO NATIONAL CONVENTION 21st Congressional District,Michael J. Zagrobelny (M),DM3,"Town of Schuyler Falls 1 ",0,6,0,0,6,3.77
DELEGATES TO NATIONAL CONVENTION 21st Congressional District,Michael J. Zagrobelny (M),DM3,"Town of Schuyler Falls 2 ",0,27,0,4,31,6.86
DELEGATES TO NATIONAL CONVENTION 21st Congressional District,Michael J. Zagrobelny (M),DM3,"Town of Schuyler Falls 3 ",0,29,0,1,30,8.09
DELEGATES TO NATIONAL CONVENTION 21st Congressional District,Sara S. Idleman (F),DM3,"City of Plattsburgh Ward 1 1 ",0,8,0,2,10,5.62
DELEGATES TO NATIONAL CONVENTION 21st Congressional District,Sara S. Idleman (F),DM3,"City of Plattsburgh Ward 1 2 ",0,93,0,28,121,9.77
DELEGATES TO NATIONAL CONVENTION 21st Congressional District,Sara S. Idleman (F),DM3,"City of Plattsburgh Ward 1 3 ",0,2,0,0,2,5.56
DELEGATES TO NATIONAL CONVENTION 21st Congressional District,Sara S. Idleman (F),DM3,"City of Plattsburgh Ward 2 1 ",0,23,0,11,34,8.74
DELEGATES TO NATIONAL CONVENTION 21st Congressional District,Sara S. Idleman (F),DM3,"City of Plattsburgh Ward 2 2 ",0,8,0,5,13,5.31
DELEGATES TO NATIONAL CONVENTION 21st Congressional District,Sara S. Idleman (F),DM3,"City of Plattsburgh Ward 3 1 ",0,42,0,7,49,8.93
DELEGATES TO NATIONAL CONVENTION 21st Congressional District,Sara S. Idleman (F),DM3,"City of Plattsburgh Ward 3 2 ",0,59,0,26,85,10.05
DELEGATES TO NATIONAL CONVENTION 21st Congressional District,Sara S. Idleman (F),DM3,"City of Plattsburgh Ward 4 1 ",0,49,0,25,74,9.18
DELEGATES TO NATIONAL CONVENTION 21st Congressional District,Sara S. Idleman (F),DM3,"City of Plattsburgh Ward 4 2 ",0,54,0,18,72,9.01
DELEGATES TO NATIONAL CONVENTION 21st Congressional District,Sara S. Idleman (F),DM3,"City of Plattsburgh Ward 5 1 ",0,31,0,11,42,7.55
DELEGATES TO NATIONAL CONVENTION 21st Congressional District,Sara S. Idleman (F),DM3,"City of Plattsburgh Ward 5 2 ",0,60,0,19,79,9.83
DELEGATES TO NATIONAL CONVENTION 21st Congressional District,Sara S. Idleman (F),DM3,"City of Plattsburgh Ward 6 1 ",0,42,0,15,57,8.44
DELEGATES TO NATIONAL CONVENTION 21st Congressional District,Sara S. Idleman (F),DM3,"City of Plattsburgh Ward 6 2 ",0,9,0,12,21,6.40
DELEGATES TO NATIONAL CONVENTION 21st Congressional District,Sara S. Idleman (F),DM3,"Town of Altona 1 ",0,20,0,12,32,7.71
DELEGATES TO NATIONAL CONVENTION 21st Congressional District,Sara S. Idleman (F),DM3,"Town of AuSable 1 ",0,13,0,7,20,8.03
DELEGATES TO NATIONAL CONVENTION 21st Congressional District,Sara S. Idleman (F),DM3,"Town of AuSable 2 ",0,16,0,7,23,8.65
DELEGATES TO NATIONAL CONVENTION 21st Congressional District,Sara S. Idleman (F),DM3,"Town of Beekmantown 1 ",0,19,0,15,34,9.39
DELEGATES TO NATIONAL CONVENTION 21st Congressional District,Sara S. Idleman (F),DM3,"Town of Beekmantown 2 ",0,20,0,6,26,8.55
DELEGATES TO NATIONAL CONVENTION 21st Congressional District,Sara S. Idleman (F),DM3,"Town of Beekmantown 3 ",0,59,0,19,78,10.43
DELEGATES TO NATIONAL CONVENTION 21st Congressional District,Sara S. Idleman (F),DM3,"Town of Beekmantown 4 ",0,31,0,13,44,11.43
DELEGATES TO NATIONAL CONVENTION 21st Congressional District,Sara S. Idleman (F),DM3,"Town of Black Brook 1 ",0,24,0,8,32,11.90
DELEGATES TO NATIONAL CONVENTION 21st Congressional District,Sara S. Idleman (F),DM3,"Town of Black Brook 2 ",0,4,0,4,8,8.33
DELEGATES TO NATIONAL CONVENTION 21st Congressional District,Sara S. Idleman (F),DM3,"Town of Champlain 1 ",0,27,0,5,32,8.29
DELEGATES TO NATIONAL CONVENTION 21st Congressional District,Sara S. Idleman (F),DM3,"Town of Champlain 2 ",0,41,0,14,55,10.40
DELEGATES TO NATIONAL CONVENTION 21st Congressional District,Sara S. Idleman (F),DM3,"Town of Champlain 3 ",0,34,0,9,43,9.64
DELEGATES TO NATIONAL CONVENTION 21st Congressional District,Sara S. Idleman (F),DM3,"Town of Chazy 1 ",0,44,0,10,54,10.61
DELEGATES TO NATIONAL CONVENTION 21st Congressional District,Sara S. Idleman (F),DM3,"Town of Chazy 2 ",0,29,0,9,38,8.64
DELEGATES TO NATIONAL CONVENTION 21st Congressional District,Sara S. Idleman (F),DM3,"Town of Clinton 1 ",0,7,0,1,8,7.62
DELEGATES TO NATIONAL CONVENTION 21st Congressional District,Sara S. Idleman (F),DM3,"Town of Dannemora 1 ",0,4,0,3,7,8.75
DELEGATES TO NATIONAL CONVENTION 21st Congressional District,Sara S. Idleman (F),DM3,"Town of Dannemora 2 ",0,11,0,2,13,10.32
DELEGATES TO NATIONAL CONVENTION 21st Congressional District,Sara S. Idleman (F),DM3,"Town of Dannemora 3 ",0,15,0,8,23,12.50
DELEGATES TO NATIONAL CONVENTION 21st Congressional District,Sara S. Idleman (F),DM3,"Town of Ellenburg 1 ",0,27,0,6,33,9.30
DELEGATES TO NATIONAL CONVENTION 21st Congressional District,Sara S. Idleman (F),DM3,"Town of Mooers 1 ",0,22,0,8,30,8.96
DELEGATES TO NATIONAL CONVENTION 21st Congressional District,Sara S. Idleman (F),DM3,"Town of Mooers 2 ",0,16,0,0,16,11.43
DELEGATES TO NATIONAL CONVENTION 21st Congressional District,Sara S. Idleman (F),DM3,"Town of Peru 1 ",0,29,0,7,36,9.65
DELEGATES TO NATIONAL CONVENTION 21st Congressional District,Sara S. Idleman (F),DM3,"Town of Peru 2 ",0,38,0,8,46,8.42
DELEGATES TO NATIONAL CONVENTION 21st Congressional District,Sara S. Idleman (F),DM3,"Town of Peru 3 ",0,13,0,2,15,7.54
DELEGATES TO NATIONAL CONVENTION 21st Congressional District,Sara S. Idleman (F),DM3,"Town of Peru 4 ",0,42,0,11,53,9.85
DELEGATES TO NATIONAL CONVENTION 21st Congressional District,Sara S. Idleman (F),DM3,"Town of Plattsburgh 1 ",0,22,0,5,27,7.24
DELEGATES TO NATIONAL CONVENTION 21st Congressional District,Sara S. Idleman (F),DM3,"Town of Plattsburgh 2 ",0,38,0,6,44,9.15
DELEGATES TO NATIONAL CONVENTION 21st Congressional District,Sara S. Idleman (F),DM3,"Town of Plattsburgh 3 ",0,33,0,23,56,8.51
DELEGATES TO NATIONAL CONVENTION 21st Congressional District,Sara S. Idleman (F),DM3,"Town of Plattsburgh 4 ",0,34,0,4,38,9.38
DELEGATES TO NATIONAL CONVENTION 21st Congressional District,Sara S. Idleman (F),DM3,"Town of Plattsburgh 5 ",0,17,0,9,26,8.52
DELEGATES TO NATIONAL CONVENTION 21st Congressional District,Sara S. Idleman (F),DM3,"Town of Plattsburgh 6 ",0,72,0,17,89,9.89
DELEGATES TO NATIONAL CONVENTION 21st Congressional District,Sara S. Idleman (F),DM3,"Town of Plattsburgh 7 ",0,21,0,2,23,6.63
DELEGATES TO NATIONAL CONVENTION 21st Congressional District,Sara S. Idleman (F),DM3,"Town of Saranac 1 ",0,36,0,8,44,10.05
DELEGATES TO NATIONAL CONVENTION 21st Congressional District,Sara S. Idleman (F),DM3,"Town of Saranac 2 ",0,16,0,7,23,9.35
DELEGATES TO NATIONAL CONVENTION 21st Congressional District,Sara S. Idleman (F),DM3,"Town of Saranac 3 ",0,12,0,6,18,8.65
DELEGATES TO NATIONAL CONVENTION 21st Congressional District,Sara S. Idleman (F),DM3,"Town of Schuyler Falls 1 ",0,10,0,3,13,8.18
DELEGATES TO NATIONAL CONVENTION 21st Congressional District,Sara S. Idleman (F),DM3,"Town of Schuyler Falls 2 ",0,33,0,6,39,8.63
DELEGATES TO NATIONAL CONVENTION 21st Congressional District,Sara S. Idleman (F),DM3,"Town of Schuyler Falls 3 ",0,27,0,5,32,8.63
DELEGATES TO NATIONAL CONVENTION 21st Congressional District,Michael S. Cashman (M),DM3,"City of Plattsburgh Ward 1 1 ",0,19,0,4,23,12.92
DELEGATES TO NATIONAL CONVENTION 21st Congressional District,Michael S. Cashman (M),DM3,"City of Plattsburgh Ward 1 2 ",0,102,0,32,134,10.82
DELEGATES TO NATIONAL CONVENTION 21st Congressional District,Michael S. Cashman (M),DM3,"City of Plattsburgh Ward 1 3 ",0,3,0,0,3,8.33
DELEGATES TO NATIONAL CONVENTION 21st Congressional District,Michael S. Cashman (M),DM3,"City of Plattsburgh Ward 2 1 ",0,24,0,18,42,10.80
DELEGATES TO NATIONAL CONVENTION 21st Congressional District,Michael S. Cashman (M),DM3,"City of Plattsburgh Ward 2 2 ",0,8,0,7,15,6.12
DELEGATES TO NATIONAL CONVENTION 21st Congressional District,Michael S. Cashman (M),DM3,"City of Plattsburgh Ward 3 1 ",0,49,0,13,62,11.29
DELEGATES TO NATIONAL CONVENTION 21st Congressional District,Michael S. Cashman (M),DM3,"City of Plattsburgh Ward 3 2 ",0,52,0,34,86,10.17
DELEGATES TO NATIONAL CONVENTION 21st Congressional District,Michael S. Cashman (M),DM3,"City of Plattsburgh Ward 4 1 ",0,55,0,27,82,10.17
DELEGATES TO NATIONAL CONVENTION 21st Congressional District,Michael S. Cashman (M),DM3,"City of Plattsburgh Ward 4 2 ",0,65,0,28,93,11.64
DELEGATES TO NATIONAL CONVENTION 21st Congressional District,Michael S. Cashman (M),DM3,"City of Plattsburgh Ward 5 1 ",0,41,0,17,58,10.43
DELEGATES TO NATIONAL CONVENTION 21st Congressional District,Michael S. Cashman (M),DM3,"City of Plattsburgh Ward 5 2 ",0,63,0,21,84,10.45
DELEGATES TO NATIONAL CONVENTION 21st Congressional District,Michael S. Cashman (M),DM3,"City of Plattsburgh Ward 6 1 ",0,51,0,10,61,9.04
DELEGATES TO NATIONAL CONVENTION 21st Congressional District,Michael S. Cashman (M),DM3,"City of Plattsburgh Ward 6 2 ",0,13,0,11,24,7.32
DELEGATES TO NATIONAL CONVENTION 21st Congressional District,Michael S. Cashman (M),DM3,"Town of Altona 1 ",0,26,0,12,38,9.16
DELEGATES TO NATIONAL CONVENTION 21st Congressional District,Michael S. Cashman (M),DM3,"Town of AuSable 1 ",0,12,0,11,23,9.24
DELEGATES TO NATIONAL CONVENTION 21st Congressional District,Michael S. Cashman (M),DM3,"Town of AuSable 2 ",0,22,0,10,32,12.03
DELEGATES TO NATIONAL CONVENTION 21st Congressional District,Michael S. Cashman (M),DM3,"Town of Beekmantown 1 ",0,30,0,15,45,12.43
DELEGATES TO NATIONAL CONVENTION 21st Congressional District,Michael S. Cashman (M),DM3,"Town of Beekmantown 2 ",0,28,0,9,37,12.17
DELEGATES TO NATIONAL CONVENTION 21st Congressional District,Michael S. Cashman (M),DM3,"Town of Beekmantown 3 ",0,66,0,20,86,11.50
DELEGATES TO NATIONAL CONVENTION 21st Congressional District,Michael S. Cashman (M),DM3,"Town of Beekmantown 4 ",0,33,0,15,48,12.47
DELEGATES TO NATIONAL CONVENTION 21st Congressional District,Michael S. Cashman (M),DM3,"Town of Black Brook 1 ",0,25,0,6,31,11.52
DELEGATES TO NATIONAL CONVENTION 21st Congressional District,Michael S. Cashman (M),DM3,"Town of Black Brook 2 ",0,5,0,4,9,9.38
DELEGATES TO NATIONAL CONVENTION 21st Congressional District,Michael S. Cashman (M),DM3,"Town of Champlain 1 ",0,37,0,8,45,11.66
DELEGATES TO NATIONAL CONVENTION 21st Congressional District,Michael S. Cashman (M),DM3,"Town of Champlain 2 ",0,42,0,12,54,10.21
DELEGATES TO NATIONAL CONVENTION 21st Congressional District,Michael S. Cashman (M),DM3,"Town of Champlain 3 ",0,34,0,6,40,8.97
DELEGATES TO NATIONAL CONVENTION 21st Congressional District,Michael S. Cashman (M),DM3,"Town of Chazy 1 ",0,48,0,10,58,11.39
DELEGATES TO NATIONAL CONVENTION 21st Congressional District,Michael S. Cashman (M),DM3,"Town of Chazy 2 ",0,30,0,7,37,8.41
DELEGATES TO NATIONAL CONVENTION 21st Congressional District,Michael S. Cashman (M),DM3,"Town of Clinton 1 ",0,13,0,0,13,12.38
DELEGATES TO NATIONAL CONVENTION 21st Congressional District,Michael S. Cashman (M),DM3,"Town of Dannemora 1 ",0,4,0,3,7,8.75
DELEGATES TO NATIONAL CONVENTION 21st Congressional District,Michael S. Cashman (M),DM3,"Town of Dannemora 2 ",0,11,0,7,18,14.29
DELEGATES TO NATIONAL CONVENTION 21st Congressional District,Michael S. Cashman (M),DM3,"Town of Dannemora 3 ",0,15,0,8,23,12.50
DELEGATES TO NATIONAL CONVENTION 21st Congressional District,Michael S. Cashman (M),DM3,"Town of Ellenburg 1 ",0,42,0,7,49,13.80
DELEGATES TO NATIONAL CONVENTION 21st Congressional District,Michael S. Cashman (M),DM3,"Town of Mooers 1 ",0,24,0,13,37,11.04
DELEGATES TO NATIONAL CONVENTION 21st Congressional District,Michael S. Cashman (M),DM3,"Town of Mooers 2 ",0,16,0,2,18,12.86
DELEGATES TO NATIONAL CONVENTION 21st Congressional District,Michael S. Cashman (M),DM3,"Town of Peru 1 ",0,37,0,5,42,11.26
DELEGATES TO NATIONAL CONVENTION 21st Congressional District,Michael S. Cashman (M),DM3,"Town of Peru 2 ",0,43,0,13,56,10.26
DELEGATES TO NATIONAL CONVENTION 21st Congressional District,Michael S. Cashman (M),DM3,"Town of Peru 3 ",0,13,0,2,15,7.54
DELEGATES TO NATIONAL CONVENTION 21st Congressional District,Michael S. Cashman (M),DM3,"Town of Peru 4 ",0,44,0,9,53,9.85
DELEGATES TO NATIONAL CONVENTION 21st Congressional District,Michael S. Cashman (M),DM3,"Town of Plattsburgh 1 ",0,30,0,8,38,10.19
DELEGATES TO NATIONAL CONVENTION 21st Congressional District,Michael S. Cashman (M),DM3,"Town of Plattsburgh 2 ",0,51,0,17,68,14.14
DELEGATES TO NATIONAL CONVENTION 21st Congressional District,Michael S. Cashman (M),DM3,"Town of Plattsburgh 3 ",0,50,0,30,80,12.16
DELEGATES TO NATIONAL CONVENTION 21st Congressional District,Michael S. Cashman (M),DM3,"Town of Plattsburgh 4 ",0,48,0,12,60,14.81
DELEGATES TO NATIONAL CONVENTION 21st Congressional District,Michael S. Cashman (M),DM3,"Town of Plattsburgh 5 ",0,25,0,9,34,11.15
DELEGATES TO NATIONAL CONVENTION 21st Congressional District,Michael S. Cashman (M),DM3,"Town of Plattsburgh 6 ",0,78,0,33,111,12.33
DELEGATES TO NATIONAL CONVENTION 21st Congressional District,Michael S. Cashman (M),DM3,"Town of Plattsburgh 7 ",0,32,0,3,35,10.09
DELEGATES TO NATIONAL CONVENTION 21st Congressional District,Michael S. Cashman (M),DM3,"Town of Saranac 1 ",0,42,0,8,50,11.42
DELEGATES TO NATIONAL CONVENTION 21st Congressional District,Michael S. Cashman (M),DM3,"Town of Saranac 2 ",0,20,0,7,27,10.98
DELEGATES TO NATIONAL CONVENTION 21st Congressional District,Michael S. Cashman (M),DM3,"Town of Saranac 3 ",0,18,0,8,26,12.50
DELEGATES TO NATIONAL CONVENTION 21st Congressional District,Michael S. Cashman (M),DM3,"Town of Schuyler Falls 1 ",0,15,0,2,17,10.69
DELEGATES TO NATIONAL CONVENTION 21st Congressional District,Michael S. Cashman (M),DM3,"Town of Schuyler Falls 2 ",0,41,0,11,52,11.50
DELEGATES TO NATIONAL CONVENTION 21st Congressional District,Michael S. Cashman (M),DM3,"Town of Schuyler Falls 3 ",0,30,0,4,34,9.16
DELEGATES TO NATIONAL CONVENTION 21st Congressional District,Toni Kennedy (F),DM5,"City of Plattsburgh Ward 1 1 ",0,4,0,3,7,3.93
DELEGATES TO NATIONAL CONVENTION 21st Congressional District,Toni Kennedy (F),DM5,"City of Plattsburgh Ward 1 2 ",0,34,0,23,57,4.60
DELEGATES TO NATIONAL CONVENTION 21st Congressional District,Toni Kennedy (F),DM5,"City of Plattsburgh Ward 1 3 ",0,2,0,0,2,5.56
DELEGATES TO NATIONAL CONVENTION 21st Congressional District,Toni Kennedy (F),DM5,"City of Plattsburgh Ward 2 1 ",0,9,0,15,24,6.17
DELEGATES TO NATIONAL CONVENTION 21st Congressional District,Toni Kennedy (F),DM5,"City of Plattsburgh Ward 2 2 ",0,7,0,9,16,6.53
DELEGATES TO NATIONAL CONVENTION 21st Congressional District,Toni Kennedy (F),DM5,"City of Plattsburgh Ward 3 1 ",0,17,0,8,25,4.55
DELEGATES TO NATIONAL CONVENTION 21st Congressional District,Toni Kennedy (F),DM5,"City of Plattsburgh Ward 3 2 ",0,28,0,16,44,5.20
DELEGATES TO NATIONAL CONVENTION 21st Congressional District,Toni Kennedy (F),DM5,"City of Plattsburgh Ward 4 1 ",0,15,0,22,37,4.59
DELEGATES TO NATIONAL CONVENTION 21st Congressional District,Toni Kennedy (F),DM5,"City of Plattsburgh Ward 4 2 ",0,22,0,14,36,4.51
DELEGATES TO NATIONAL CONVENTION 21st Congressional District,Toni Kennedy (F),DM5,"City of Plattsburgh Ward 5 1 ",0,21,0,8,29,5.22
DELEGATES TO NATIONAL CONVENTION 21st Congressional District,Toni Kennedy (F),DM5,"City of Plattsburgh Ward 5 2 ",0,30,0,16,46,5.72
DELEGATES TO NATIONAL CONVENTION 21st Congressional District,Toni Kennedy (F),DM5,"City of Plattsburgh Ward 6 1 ",0,21,0,12,33,4.89
DELEGATES TO NATIONAL CONVENTION 21st Congressional District,Toni Kennedy (F),DM5,"City of Plattsburgh Ward 6 2 ",0,13,0,16,29,8.84
DELEGATES TO NATIONAL CONVENTION 21st Congressional District,Toni Kennedy (F),DM5,"Town of Altona 1 ",0,21,0,4,25,6.02
DELEGATES TO NATIONAL CONVENTION 21st Congressional District,Toni Kennedy (F),DM5,"Town of AuSable 1 ",0,4,0,7,11,4.42
DELEGATES TO NATIONAL CONVENTION 21st Congressional District,Toni Kennedy (F),DM5,"Town of AuSable 2 ",0,10,0,2,12,4.51
DELEGATES TO NATIONAL CONVENTION 21st Congressional District,Toni Kennedy (F),DM5,"Town of Beekmantown 1 ",0,7,0,5,12,3.31
DELEGATES TO NATIONAL CONVENTION 21st Congressional District,Toni Kennedy (F),DM5,"Town of Beekmantown 2 ",0,9,0,7,16,5.26
DELEGATES TO NATIONAL CONVENTION 21st Congressional District,Toni Kennedy (F),DM5,"Town of Beekmantown 3 ",0,20,0,15,35,4.68
DELEGATES TO NATIONAL CONVENTION 21st Congressional District,Toni Kennedy (F),DM5,"Town of Beekmantown 4 ",0,6,0,6,12,3.12
DELEGATES TO NATIONAL CONVENTION 21st Congressional District,Toni Kennedy (F),DM5,"Town of Black Brook 1 ",0,2,0,4,6,2.23
DELEGATES TO NATIONAL CONVENTION 21st Congressional District,Toni Kennedy (F),DM5,"Town of Black Brook 2 ",0,3,0,2,5,5.21
DELEGATES TO NATIONAL CONVENTION 21st Congressional District,Toni Kennedy (F),DM5,"Town of Champlain 1 ",0,12,0,3,15,3.89
DELEGATES TO NATIONAL CONVENTION 21st Congressional District,Toni Kennedy (F),DM5,"Town of Champlain 2 ",0,21,0,5,26,4.91
DELEGATES TO NATIONAL CONVENTION 21st Congressional District,Toni Kennedy (F),DM5,"Town of Champlain 3 ",0,8,0,10,18,4.04
DELEGATES TO NATIONAL CONVENTION 21st Congressional District,Toni Kennedy (F),DM5,"Town of Chazy 1 ",0,14,0,4,18,3.54
DELEGATES TO NATIONAL CONVENTION 21st Congressional District,Toni Kennedy (F),DM5,"Town of Chazy 2 ",0,19,0,5,24,5.45
DELEGATES TO NATIONAL CONVENTION 21st Congressional District,Toni Kennedy (F),DM5,"Town of Clinton 1 ",0,3,0,3,6,5.71
DELEGATES TO NATIONAL CONVENTION 21st Congressional District,Toni Kennedy (F),DM5,"Town of Dannemora 1 ",0,0,0,1,1,1.25
DELEGATES TO NATIONAL CONVENTION 21st Congressional District,Toni Kennedy (F),DM5,"Town of Dannemora 2 ",0,4,0,3,7,5.56
DELEGATES TO NATIONAL CONVENTION 21st Congressional District,Toni Kennedy (F),DM5,"Town of Dannemora 3 ",0,1,0,0,1,0.54
DELEGATES TO NATIONAL CONVENTION 21st Congressional District,Toni Kennedy (F),DM5,"Town of Ellenburg 1 ",0,13,0,1,14,3.94
DELEGATES TO NATIONAL CONVENTION 21st Congressional District,Toni Kennedy (F),DM5,"Town of Mooers 1 ",0,11,0,5,16,4.78
DELEGATES TO NATIONAL CONVENTION 21st Congressional District,Toni Kennedy (F),DM5,"Town of Mooers 2 ",0,4,0,1,5,3.57
DELEGATES TO NATIONAL CONVENTION 21st Congressional District,Toni Kennedy (F),DM5,"Town of Peru 1 ",0,14,0,4,18,4.83
DELEGATES TO NATIONAL CONVENTION 21st Congressional District,Toni Kennedy (F),DM5,"Town of Peru 2 ",0,22,0,12,34,6.23
DELEGATES TO NATIONAL CONVENTION 21st Congressional District,Toni Kennedy (F),DM5,"Town of Peru 3 ",0,11,0,1,12,6.03
DELEGATES TO NATIONAL CONVENTION 21st Congressional District,Toni Kennedy (F),DM5,"Town of Peru 4 ",0,15,0,8,23,4.28
DELEGATES TO NATIONAL CONVENTION 21st Congressional District,Toni Kennedy (F),DM5,"Town of Plattsburgh 1 ",0,14,0,6,20,5.36
DELEGATES TO NATIONAL CONVENTION 21st Congressional District,Toni Kennedy (F),DM5,"Town of Plattsburgh 2 ",0,15,0,4,19,3.95
DELEGATES TO NATIONAL CONVENTION 21st Congressional District,Toni Kennedy (F),DM5,"Town of Plattsburgh 3 ",0,26,0,11,37,5.62
DELEGATES TO NATIONAL CONVENTION 21st Congressional District,Toni Kennedy (F),DM5,"Town of Plattsburgh 4 ",0,7,0,6,13,3.21
DELEGATES TO NATIONAL CONVENTION 21st Congressional District,Toni Kennedy (F),DM5,"Town of Plattsburgh 5 ",0,11,0,1,12,3.93
DELEGATES TO NATIONAL CONVENTION 21st Congressional District,Toni Kennedy (F),DM5,"Town of Plattsburgh 6 ",0,26,0,10,36,4.00
DELEGATES TO NATIONAL CONVENTION 21st Congressional District,Toni Kennedy (F),DM5,"Town of Plattsburgh 7 ",0,12,0,10,22,6.34
DELEGATES TO NATIONAL CONVENTION 21st Congressional District,Toni Kennedy (F),DM5,"Town of Saranac 1 ",0,15,0,4,19,4.34
DELEGATES TO NATIONAL CONVENTION 21st Congressional District,Toni Kennedy (F),DM5,"Town of Saranac 2 ",0,4,0,8,12,4.88
DELEGATES TO NATIONAL CONVENTION 21st Congressional District,Toni Kennedy (F),DM5,"Town of Saranac 3 ",0,7,0,4,11,5.29
DELEGATES TO NATIONAL CONVENTION 21st Congressional District,Toni Kennedy (F),DM5,"Town of Schuyler Falls 1 ",0,6,0,2,8,5.03
DELEGATES TO NATIONAL CONVENTION 21st Congressional District,Toni Kennedy (F),DM5,"Town of Schuyler Falls 2 ",0,13,0,5,18,3.98
DELEGATES TO NATIONAL CONVENTION 21st Congressional District,Toni Kennedy (F),DM5,"Town of Schuyler Falls 3 ",0,8,0,8,16,4.31
DELEGATES TO NATIONAL CONVENTION 21st Congressional District,Diana Klementowski (F),DM5,"City of Plattsburgh Ward 1 1 ",0,6,0,3,9,5.06
DELEGATES TO NATIONAL CONVENTION 21st Congressional District,Diana Klementowski (F),DM5,"City of Plattsburgh Ward 1 2 ",0,31,0,22,53,4.28
DELEGATES TO NATIONAL CONVENTION 21st Congressional District,Diana Klementowski (F),DM5,"City of Plattsburgh Ward 1 3 ",0,2,0,0,2,5.56
DELEGATES TO NATIONAL CONVENTION 21st Congressional District,Diana Klementowski (F),DM5,"City of Plattsburgh Ward 2 1 ",0,10,0,14,24,6.17
DELEGATES TO NATIONAL CONVENTION 21st Congressional District,Diana Klementowski (F),DM5,"City of Plattsburgh Ward 2 2 ",0,5,0,8,13,5.31
DELEGATES TO NATIONAL CONVENTION 21st Congressional District,Diana Klementowski (F),DM5,"City of Plattsburgh Ward 3 1 ",0,17,0,8,25,4.55
DELEGATES TO NATIONAL CONVENTION 21st Congressional District,Diana Klementowski (F),DM5,"City of Plattsburgh Ward 3 2 ",0,28,0,15,43,5.08
DELEGATES TO NATIONAL CONVENTION 21st Congressional District,Diana Klementowski (F),DM5,"City of Plattsburgh Ward 4 1 ",0,21,0,25,46,5.71
DELEGATES TO NATIONAL CONVENTION 21st Congressional District,Diana Klementowski (F),DM5,"City of Plattsburgh Ward 4 2 ",0,25,0,20,45,5.63
DELEGATES TO NATIONAL CONVENTION 21st Congressional District,Diana Klementowski (F),DM5,"City of Plattsburgh Ward 5 1 ",0,17,0,10,27,4.86
DELEGATES TO NATIONAL CONVENTION 21st Congressional District,Diana Klementowski (F),DM5,"City of Plattsburgh Ward 5 2 ",0,27,0,19,46,5.72
DELEGATES TO NATIONAL CONVENTION 21st Congressional District,Diana Klementowski (F),DM5,"City of Plattsburgh Ward 6 1 ",0,23,0,17,40,5.93
DELEGATES TO NATIONAL CONVENTION 21st Congressional District,Diana Klementowski (F),DM5,"City of Plattsburgh Ward 6 2 ",0,17,0,15,32,9.76
DELEGATES TO NATIONAL CONVENTION 21st Congressional District,Diana Klementowski (F),DM5,"Town of Altona 1 ",0,20,0,6,26,6.27
DELEGATES TO NATIONAL CONVENTION 21st Congressional District,Diana Klementowski (F),DM5,"Town of AuSable 1 ",0,4,0,8,12,4.82
DELEGATES TO NATIONAL CONVENTION 21st Congressional District,Diana Klementowski (F),DM5,"Town of AuSable 2 ",0,6,0,5,11,4.14
DELEGATES TO NATIONAL CONVENTION 21st Congressional District,Diana Klementowski (F),DM5,"Town of Beekmantown 1 ",0,7,0,5,12,3.31
DELEGATES TO NATIONAL CONVENTION 21st Congressional District,Diana Klementowski (F),DM5,"Town of Beekmantown 2 ",0,4,0,6,10,3.29
DELEGATES TO NATIONAL CONVENTION 21st Congressional District,Diana Klementowski (F),DM5,"Town of Beekmantown 3 ",0,15,0,15,30,4.01
DELEGATES TO NATIONAL CONVENTION 21st Congressional District,Diana Klementowski (F),DM5,"Town of Beekmantown 4 ",0,7,0,4,11,2.86
DELEGATES TO NATIONAL CONVENTION 21st Congressional District,Diana Klementowski (F),DM5,"Town of Black Brook 1 ",0,2,0,6,8,2.97
DELEGATES TO NATIONAL CONVENTION 21st Congressional District,Diana Klementowski (F),DM5,"Town of Black Brook 2 ",0,3,0,1,4,4.17
DELEGATES TO NATIONAL CONVENTION 21st Congressional District,Diana Klementowski (F),DM5,"Town of Champlain 1 ",0,11,0,3,14,3.63
DELEGATES TO NATIONAL CONVENTION 21st Congressional District,Diana Klementowski (F),DM5,"Town of Champlain 2 ",0,15,0,7,22,4.16
DELEGATES TO NATIONAL CONVENTION 21st Congressional District,Diana Klementowski (F),DM5,"Town of Champlain 3 ",0,12,0,15,27,6.05
DELEGATES TO NATIONAL CONVENTION 21st Congressional District,Diana Klementowski (F),DM5,"Town of Chazy 1 ",0,18,0,4,22,4.32
DELEGATES TO NATIONAL CONVENTION 21st Congressional District,Diana Klementowski (F),DM5,"Town of Chazy 2 ",0,24,0,4,28,6.36
DELEGATES TO NATIONAL CONVENTION 21st Congressional District,Diana Klementowski (F),DM5,"Town of Clinton 1 ",0,0,0,4,4,3.81
DELEGATES TO NATIONAL CONVENTION 21st Congressional District,Diana Klementowski (F),DM5,"Town of Dannemora 1 ",0,0,0,1,1,1.25
DELEGATES TO NATIONAL CONVENTION 21st Congressional District,Diana Klementowski (F),DM5,"Town of Dannemora 2 ",0,4,0,3,7,5.56
DELEGATES TO NATIONAL CONVENTION 21st Congressional District,Diana Klementowski (F),DM5,"Town of Dannemora 3 ",0,2,0,6,8,4.35
DELEGATES TO NATIONAL CONVENTION 21st Congressional District,Diana Klementowski (F),DM5,"Town of Ellenburg 1 ",0,4,0,4,8,2.25
DELEGATES TO NATIONAL CONVENTION 21st Congressional District,Diana Klementowski (F),DM5,"Town of Mooers 1 ",0,5,0,5,10,2.99
DELEGATES TO NATIONAL CONVENTION 21st Congressional District,Diana Klementowski (F),DM5,"Town of Mooers 2 ",0,2,0,2,4,2.86
DELEGATES TO NATIONAL CONVENTION 21st Congressional District,Diana Klementowski (F),DM5,"Town of Peru 1 ",0,14,0,5,19,5.09
DELEGATES TO NATIONAL CONVENTION 21st Congressional District,Diana Klementowski (F),DM5,"Town of Peru 2 ",0,25,0,10,35,6.41
DELEGATES TO NATIONAL CONVENTION 21st Congressional District,Diana Klementowski (F),DM5,"Town of Peru 3 ",0,13,0,1,14,7.04
DELEGATES TO NATIONAL CONVENTION 21st Congressional District,Diana Klementowski (F),DM5,"Town of Peru 4 ",0,15,0,10,25,4.65
DELEGATES TO NATIONAL CONVENTION 21st Congressional District,Diana Klementowski (F),DM5,"Town of Plattsburgh 1 ",0,11,0,5,16,4.29
DELEGATES TO NATIONAL CONVENTION 21st Congressional District,Diana Klementowski (F),DM5,"Town of Plattsburgh 2 ",0,20,0,5,25,5.20
DELEGATES TO NATIONAL CONVENTION 21st Congressional District,Diana Klementowski (F),DM5,"Town of Plattsburgh 3 ",0,14,0,16,30,4.56
DELEGATES TO NATIONAL CONVENTION 21st Congressional District,Diana Klementowski (F),DM5,"Town of Plattsburgh 4 ",0,8,0,6,14,3.46
DELEGATES TO NATIONAL CONVENTION 21st Congressional District,Diana Klementowski (F),DM5,"Town of Plattsburgh 5 ",0,15,0,4,19,6.23
DELEGATES TO NATIONAL CONVENTION 21st Congressional District,Diana Klementowski (F),DM5,"Town of Plattsburgh 6 ",0,27,0,16,43,4.78
DELEGATES TO NATIONAL CONVENTION 21st Congressional District,Diana Klementowski (F),DM5,"Town of Plattsburgh 7 ",0,10,0,11,21,6.05
DELEGATES TO NATIONAL CONVENTION 21st Congressional District,Diana Klementowski (F),DM5,"Town of Saranac 1 ",0,16,0,5,21,4.79
DELEGATES TO NATIONAL CONVENTION 21st Congressional District,Diana Klementowski (F),DM5,"Town of Saranac 2 ",0,7,0,6,13,5.28
DELEGATES TO NATIONAL CONVENTION 21st Congressional District,Diana Klementowski (F),DM5,"Town of Saranac 3 ",0,5,0,4,9,4.33
DELEGATES TO NATIONAL CONVENTION 21st Congressional District,Diana Klementowski (F),DM5,"Town of Schuyler Falls 1 ",0,4,0,2,6,3.77
DELEGATES TO NATIONAL CONVENTION 21st Congressional District,Diana Klementowski (F),DM5,"Town of Schuyler Falls 2 ",0,14,0,5,19,4.20
DELEGATES TO NATIONAL CONVENTION 21st Congressional District,Diana Klementowski (F),DM5,"Town of Schuyler Falls 3 ",0,7,0,6,13,3.50
DELEGATES TO NATIONAL CONVENTION 21st Congressional District,Kristi-Ann Lyga (F),DM5,"City of Plattsburgh Ward 1 1 ",0,4,0,3,7,3.93
DELEGATES TO NATIONAL CONVENTION 21st Congressional District,Kristi-Ann Lyga (F),DM5,"City of Plattsburgh Ward 1 2 ",0,29,0,18,47,3.80
DELEGATES TO NATIONAL CONVENTION 21st Congressional District,Kristi-Ann Lyga (F),DM5,"City of Plattsburgh Ward 1 3 ",0,2,0,0,2,5.56
DELEGATES TO NATIONAL CONVENTION 21st Congressional District,Kristi-Ann Lyga (F),DM5,"City of Plattsburgh Ward 2 1 ",0,8,0,15,23,5.91
DELEGATES TO NATIONAL CONVENTION 21st Congressional District,Kristi-Ann Lyga (F),DM5,"City of Plattsburgh Ward 2 2 ",0,5,0,7,12,4.90
DELEGATES TO NATIONAL CONVENTION 21st Congressional District,Kristi-Ann Lyga (F),DM5,"City of Plattsburgh Ward 3 1 ",0,15,0,5,20,3.64
DELEGATES TO NATIONAL CONVENTION 21st Congressional District,Kristi-Ann Lyga (F),DM5,"City of Plattsburgh Ward 3 2 ",0,28,0,17,45,5.32
DELEGATES TO NATIONAL CONVENTION 21st Congressional District,Kristi-Ann Lyga (F),DM5,"City of Plattsburgh Ward 4 1 ",0,11,0,21,32,3.97
DELEGATES TO NATIONAL CONVENTION 21st Congressional District,Kristi-Ann Lyga (F),DM5,"City of Plattsburgh Ward 4 2 ",0,16,0,11,27,3.38
DELEGATES TO NATIONAL CONVENTION 21st Congressional District,Kristi-Ann Lyga (F),DM5,"City of Plattsburgh Ward 5 1 ",0,18,0,14,32,5.76
DELEGATES TO NATIONAL CONVENTION 21st Congressional District,Kristi-Ann Lyga (F),DM5,"City of Plattsburgh Ward 5 2 ",0,20,0,14,34,4.23
DELEGATES TO NATIONAL CONVENTION 21st Congressional District,Kristi-Ann Lyga (F),DM5,"City of Plattsburgh Ward 6 1 ",0,20,0,15,35,5.19
DELEGATES TO NATIONAL CONVENTION 21st Congressional District,Kristi-Ann Lyga (F),DM5,"City of Plattsburgh Ward 6 2 ",0,14,0,13,27,8.23
DELEGATES TO NATIONAL CONVENTION 21st Congressional District,Kristi-Ann Lyga (F),DM5,"Town of Altona 1 ",0,18,0,4,22,5.30
DELEGATES TO NATIONAL CONVENTION 21st Congressional District,Kristi-Ann Lyga (F),DM5,"Town of AuSable 1 ",0,4,0,11,15,6.02
DELEGATES TO NATIONAL CONVENTION 21st Congressional District,Kristi-Ann Lyga (F),DM5,"Town of AuSable 2 ",0,9,0,3,12,4.51
DELEGATES TO NATIONAL CONVENTION 21st Congressional District,Kristi-Ann Lyga (F),DM5,"Town of Beekmantown 1 ",0,8,0,4,12,3.31
DELEGATES TO NATIONAL CONVENTION 21st Congressional District,Kristi-Ann Lyga (F),DM5,"Town of Beekmantown 2 ",0,5,0,8,13,4.28
DELEGATES TO NATIONAL CONVENTION 21st Congressional District,Kristi-Ann Lyga (F),DM5,"Town of Beekmantown 3 ",0,15,0,17,32,4.28
DELEGATES TO NATIONAL CONVENTION 21st Congressional District,Kristi-Ann Lyga (F),DM5,"Town of Beekmantown 4 ",0,6,0,5,11,2.86
DELEGATES TO NATIONAL CONVENTION 21st Congressional District,Kristi-Ann Lyga (F),DM5,"Town of Black Brook 1 ",0,1,0,4,5,1.86
DELEGATES TO NATIONAL CONVENTION 21st Congressional District,Kristi-Ann Lyga (F),DM5,"Town of Black Brook 2 ",0,3,0,2,5,5.21
DELEGATES TO NATIONAL CONVENTION 21st Congressional District,Kristi-Ann Lyga (F),DM5,"Town of Champlain 1 ",0,9,0,2,11,2.85
DELEGATES TO NATIONAL CONVENTION 21st Congressional District,Kristi-Ann Lyga (F),DM5,"Town of Champlain 2 ",0,15,0,5,20,3.78
DELEGATES TO NATIONAL CONVENTION 21st Congressional District,Kristi-Ann Lyga (F),DM5,"Town of Champlain 3 ",0,7,0,12,19,4.26
DELEGATES TO NATIONAL CONVENTION 21st Congressional District,Kristi-Ann Lyga (F),DM5,"Town of Chazy 1 ",0,13,0,4,17,3.34
DELEGATES TO NATIONAL CONVENTION 21st Congressional District,Kristi-Ann Lyga (F),DM5,"Town of Chazy 2 ",0,15,0,3,18,4.09
DELEGATES TO NATIONAL CONVENTION 21st Congressional District,Kristi-Ann Lyga (F),DM5,"Town of Clinton 1 ",0,1,0,2,3,2.86
DELEGATES TO NATIONAL CONVENTION 21st Congressional District,Kristi-Ann Lyga (F),DM5,"Town of Dannemora 1 ",0,0,0,1,1,1.25
DELEGATES TO NATIONAL CONVENTION 21st Congressional District,Kristi-Ann Lyga (F),DM5,"Town of Dannemora 2 ",0,4,0,1,5,3.97
DELEGATES TO NATIONAL CONVENTION 21st Congressional District,Kristi-Ann Lyga (F),DM5,"Town of Dannemora 3 ",0,1,0,6,7,3.80
DELEGATES TO NATIONAL CONVENTION 21st Congressional District,Kristi-Ann Lyga (F),DM5,"Town of Ellenburg 1 ",0,7,0,2,9,2.54
DELEGATES TO NATIONAL CONVENTION 21st Congressional District,Kristi-Ann Lyga (F),DM5,"Town of Mooers 1 ",0,3,0,4,7,2.09
DELEGATES TO NATIONAL CONVENTION 21st Congressional District,Kristi-Ann Lyga (F),DM5,"Town of Mooers 2 ",0,2,0,0,2,1.43
DELEGATES TO NATIONAL CONVENTION 21st Congressional District,Kristi-Ann Lyga (F),DM5,"Town of Peru 1 ",0,11,0,3,14,3.75
DELEGATES TO NATIONAL CONVENTION 21st Congressional District,Kristi-Ann Lyga (F),DM5,"Town of Peru 2 ",0,19,0,8,27,4.95
DELEGATES TO NATIONAL CONVENTION 21st Congressional District,Kristi-Ann Lyga (F),DM5,"Town of Peru 3 ",0,9,0,0,9,4.52
DELEGATES TO NATIONAL CONVENTION 21st Congressional District,Kristi-Ann Lyga (F),DM5,"Town of Peru 4 ",0,15,0,10,25,4.65
DELEGATES TO NATIONAL CONVENTION 21st Congressional District,Kristi-Ann Lyga (F),DM5,"Town of Plattsburgh 1 ",0,12,0,4,16,4.29
DELEGATES TO NATIONAL CONVENTION 21st Congressional District,Kristi-Ann Lyga (F),DM5,"Town of Plattsburgh 2 ",0,10,0,6,16,3.33
DELEGATES TO NATIONAL CONVENTION 21st Congressional District,Kristi-Ann Lyga (F),DM5,"Town of Plattsburgh 3 ",0,15,0,10,25,3.80
DELEGATES TO NATIONAL CONVENTION 21st Congressional District,Kristi-Ann Lyga (F),DM5,"Town of Plattsburgh 4 ",0,8,0,6,14,3.46
DELEGATES TO NATIONAL CONVENTION 21st Congressional District,Kristi-Ann Lyga (F),DM5,"Town of Plattsburgh 5 ",0,9,0,1,10,3.28
DELEGATES TO NATIONAL CONVENTION 21st Congressional District,Kristi-Ann Lyga (F),DM5,"Town of Plattsburgh 6 ",0,28,0,13,41,4.56
DELEGATES TO NATIONAL CONVENTION 21st Congressional District,Kristi-Ann Lyga (F),DM5,"Town of Plattsburgh 7 ",0,16,0,9,25,7.20
DELEGATES TO NATIONAL CONVENTION 21st Congressional District,Kristi-Ann Lyga (F),DM5,"Town of Saranac 1 ",0,15,0,4,19,4.34
DELEGATES TO NATIONAL CONVENTION 21st Congressional District,Kristi-Ann Lyga (F),DM5,"Town of Saranac 2 ",0,6,0,8,14,5.69
DELEGATES TO NATIONAL CONVENTION 21st Congressional District,Kristi-Ann Lyga (F),DM5,"Town of Saranac 3 ",0,4,0,2,6,2.88
DELEGATES TO NATIONAL CONVENTION 21st Congressional District,Kristi-Ann Lyga (F),DM5,"Town of Schuyler Falls 1 ",0,4,0,2,6,3.77
DELEGATES TO NATIONAL CONVENTION 21st Congressional District,Kristi-Ann Lyga (F),DM5,"Town of Schuyler Falls 2 ",0,11,0,3,14,3.10
DELEGATES TO NATIONAL CONVENTION 21st Congressional District,Kristi-Ann Lyga (F),DM5,"Town of Schuyler Falls 3 ",0,6,0,4,10,2.70
DELEGATES TO NATIONAL CONVENTION 21st Congressional District,Jay Bellanca (M),DM5,"City of Plattsburgh Ward 1 1 ",0,2,0,2,4,2.25
DELEGATES TO NATIONAL CONVENTION 21st Congressional District,Jay Bellanca (M),DM5,"City of Plattsburgh Ward 1 2 ",0,14,0,21,35,2.83
DELEGATES TO NATIONAL CONVENTION 21st Congressional District,Jay Bellanca (M),DM5,"City of Plattsburgh Ward 1 3 ",0,2,0,0,2,5.56
DELEGATES TO NATIONAL CONVENTION 21st Congressional District,Jay Bellanca (M),DM5,"City of Plattsburgh Ward 2 1 ",0,8,0,13,21,5.40
DELEGATES TO NATIONAL CONVENTION 21st Congressional District,Jay Bellanca (M),DM5,"City of Plattsburgh Ward 2 2 ",0,5,0,7,12,4.90
DELEGATES TO NATIONAL CONVENTION 21st Congressional District,Jay Bellanca (M),DM5,"City of Plattsburgh Ward 3 1 ",0,11,0,8,19,3.46
DELEGATES TO NATIONAL CONVENTION 21st Congressional District,Jay Bellanca (M),DM5,"City of Plattsburgh Ward 3 2 ",0,19,0,7,26,3.07
DELEGATES TO NATIONAL CONVENTION 21st Congressional District,Jay Bellanca (M),DM5,"City of Plattsburgh Ward 4 1 ",0,10,0,18,28,3.47
DELEGATES TO NATIONAL CONVENTION 21st Congressional District,Jay Bellanca (M),DM5,"City of Plattsburgh Ward 4 2 ",0,14,0,9,23,2.88
DELEGATES TO NATIONAL CONVENTION 21st Congressional District,Jay Bellanca (M),DM5,"City of Plattsburgh Ward 5 1 ",0,11,0,11,22,3.96
DELEGATES TO NATIONAL CONVENTION 21st Congressional District,Jay Bellanca (M),DM5,"City of Plattsburgh Ward 5 2 ",0,17,0,13,30,3.73
DELEGATES TO NATIONAL CONVENTION 21st Congressional District,Jay Bellanca (M),DM5,"City of Plattsburgh Ward 6 1 ",0,19,0,13,32,4.74
DELEGATES TO NATIONAL CONVENTION 21st Congressional District,Jay Bellanca (M),DM5,"City of Plattsburgh Ward 6 2 ",0,11,0,13,24,7.32
DELEGATES TO NATIONAL CONVENTION 21st Congressional District,Jay Bellanca (M),DM5,"Town of Altona 1 ",0,16,0,2,18,4.34
DELEGATES TO NATIONAL CONVENTION 21st Congressional District,Jay Bellanca (M),DM5,"Town of AuSable 1 ",0,4,0,4,8,3.21
DELEGATES TO NATIONAL CONVENTION 21st Congressional District,Jay Bellanca (M),DM5,"Town of AuSable 2 ",0,8,0,1,9,3.38
DELEGATES TO NATIONAL CONVENTION 21st Congressional District,Jay Bellanca (M),DM5,"Town of Beekmantown 1 ",0,6,0,4,10,2.76
DELEGATES TO NATIONAL CONVENTION 21st Congressional District,Jay Bellanca (M),DM5,"Town of Beekmantown 2 ",0,6,0,6,12,3.95
DELEGATES TO NATIONAL CONVENTION 21st Congressional District,Jay Bellanca (M),DM5,"Town of Beekmantown 3 ",0,13,0,13,26,3.48
DELEGATES TO NATIONAL CONVENTION 21st Congressional District,Jay Bellanca (M),DM5,"Town of Beekmantown 4 ",0,7,0,4,11,2.86
DELEGATES TO NATIONAL CONVENTION 21st Congressional District,Jay Bellanca (M),DM5,"Town of Black Brook 1 ",0,0,0,3,3,1.12
DELEGATES TO NATIONAL CONVENTION 21st Congressional District,Jay Bellanca (M),DM5,"Town of Black Brook 2 ",0,3,0,2,5,5.21
DELEGATES TO NATIONAL CONVENTION 21st Congressional District,Jay Bellanca (M),DM5,"Town of Champlain 1 ",0,6,0,2,8,2.07
DELEGATES TO NATIONAL CONVENTION 21st Congressional District,Jay Bellanca (M),DM5,"Town of Champlain 2 ",0,17,0,5,22,4.16
DELEGATES TO NATIONAL CONVENTION 21st Congressional District,Jay Bellanca (M),DM5,"Town of Champlain 3 ",0,6,0,9,15,3.36
DELEGATES TO NATIONAL CONVENTION 21st Congressional District,Jay Bellanca (M),DM5,"Town of Chazy 1 ",0,14,0,4,18,3.54
DELEGATES TO NATIONAL CONVENTION 21st Congressional District,Jay Bellanca (M),DM5,"Town of Chazy 2 ",0,11,0,2,13,2.95
DELEGATES TO NATIONAL CONVENTION 21st Congressional District,Jay Bellanca (M),DM5,"Town of Clinton 1 ",0,1,0,2,3,2.86
DELEGATES TO NATIONAL CONVENTION 21st Congressional District,Jay Bellanca (M),DM5,"Town of Dannemora 1 ",0,0,0,0,0,0.00
DELEGATES TO NATIONAL CONVENTION 21st Congressional District,Jay Bellanca (M),DM5,"Town of Dannemora 2 ",0,2,0,1,3,2.38
DELEGATES TO NATIONAL CONVENTION 21st Congressional District,Jay Bellanca (M),DM5,"Town of Dannemora 3 ",0,1,0,1,2,1.09
DELEGATES TO NATIONAL CONVENTION 21st Congressional District,Jay Bellanca (M),DM5,"Town of Ellenburg 1 ",0,6,0,0,6,1.69
DELEGATES TO NATIONAL CONVENTION 21st Congressional District,Jay Bellanca (M),DM5,"Town of Mooers 1 ",0,5,0,3,8,2.39
DELEGATES TO NATIONAL CONVENTION 21st Congressional District,Jay Bellanca (M),DM5,"Town of Mooers 2 ",0,2,0,0,2,1.43
DELEGATES TO NATIONAL CONVENTION 21st Congressional District,Jay Bellanca (M),DM5,"Town of Peru 1 ",0,8,0,1,9,2.41
DELEGATES TO NATIONAL CONVENTION 21st Congressional District,Jay Bellanca (M),DM5,"Town of Peru 2 ",0,20,0,8,28,5.13
DELEGATES TO NATIONAL CONVENTION 21st Congressional District,Jay Bellanca (M),DM5,"Town of Peru 3 ",0,9,0,1,10,5.03
DELEGATES TO NATIONAL CONVENTION 21st Congressional District,Jay Bellanca (M),DM5,"Town of Peru 4 ",0,10,0,5,15,2.79
DELEGATES TO NATIONAL CONVENTION 21st Congressional District,Jay Bellanca (M),DM5,"Town of Plattsburgh 1 ",0,8,0,5,13,3.49
DELEGATES TO NATIONAL CONVENTION 21st Congressional District,Jay Bellanca (M),DM5,"Town of Plattsburgh 2 ",0,14,0,2,16,3.33
DELEGATES TO NATIONAL CONVENTION 21st Congressional District,Jay Bellanca (M),DM5,"Town of Plattsburgh 3 ",0,12,0,11,23,3.50
DELEGATES TO NATIONAL CONVENTION 21st Congressional District,Jay Bellanca (M),DM5,"Town of Plattsburgh 4 ",0,2,0,6,8,1.98
DELEGATES TO NATIONAL CONVENTION 21st Congressional District,Jay Bellanca (M),DM5,"Town of Plattsburgh 5 ",0,10,0,4,14,4.59
DELEGATES TO NATIONAL CONVENTION 21st Congressional District,Jay Bellanca (M),DM5,"Town of Plattsburgh 6 ",0,20,0,11,31,3.44
DELEGATES TO NATIONAL CONVENTION 21st Congressional District,Jay Bellanca (M),DM5,"Town of Plattsburgh 7 ",0,7,0,8,15,4.32
DELEGATES TO NATIONAL CONVENTION 21st Congressional District,Jay Bellanca (M),DM5,"Town of Saranac 1 ",0,12,0,3,15,3.42
DELEGATES TO NATIONAL CONVENTION 21st Congressional District,Jay Bellanca (M),DM5,"Town of Saranac 2 ",0,6,0,5,11,4.47
DELEGATES TO NATIONAL CONVENTION 21st Congressional District,Jay Bellanca (M),DM5,"Town of Saranac 3 ",0,3,0,6,9,4.33
DELEGATES TO NATIONAL CONVENTION 21st Congressional District,Jay Bellanca (M),DM5,"Town of Schuyler Falls 1 ",0,3,0,1,4,2.52
DELEGATES TO NATIONAL CONVENTION 21st Congressional District,Jay Bellanca (M),DM5,"Town of Schuyler Falls 2 ",0,8,0,4,12,2.65
DELEGATES TO NATIONAL CONVENTION 21st Congressional District,Jay Bellanca (M),DM5,"Town of Schuyler Falls 3 ",0,6,0,4,10,2.70
DELEGATES TO NATIONAL CONVENTION 21st Congressional District,Joseph Henderson (M),DM5,"City of Plattsburgh Ward 1 1 ",0,3,0,3,6,3.37
DELEGATES TO NATIONAL CONVENTION 21st Congressional District,Joseph Henderson (M),DM5,"City of Plattsburgh Ward 1 2 ",0,16,0,16,32,2.58
DELEGATES TO NATIONAL CONVENTION 21st Congressional District,Joseph Henderson (M),DM5,"City of Plattsburgh Ward 1 3 ",0,2,0,0,2,5.56
DELEGATES TO NATIONAL CONVENTION 21st Congressional District,Joseph Henderson (M),DM5,"City of Plattsburgh Ward 2 1 ",0,8,0,11,19,4.88
DELEGATES TO NATIONAL CONVENTION 21st Congressional District,Joseph Henderson (M),DM5,"City of Plattsburgh Ward 2 2 ",0,4,0,9,13,5.31
DELEGATES TO NATIONAL CONVENTION 21st Congressional District,Joseph Henderson (M),DM5,"City of Plattsburgh Ward 3 1 ",0,11,0,5,16,2.91
DELEGATES TO NATIONAL CONVENTION 21st Congressional District,Joseph Henderson (M),DM5,"City of Plattsburgh Ward 3 2 ",0,19,0,10,29,3.43
DELEGATES TO NATIONAL CONVENTION 21st Congressional District,Joseph Henderson (M),DM5,"City of Plattsburgh Ward 4 1 ",0,13,0,14,27,3.35
DELEGATES TO NATIONAL CONVENTION 21st Congressional District,Joseph Henderson (M),DM5,"City of Plattsburgh Ward 4 2 ",0,16,0,8,24,3.00
DELEGATES TO NATIONAL CONVENTION 21st Congressional District,Joseph Henderson (M),DM5,"City of Plattsburgh Ward 5 1 ",0,13,0,8,21,3.78
DELEGATES TO NATIONAL CONVENTION 21st Congressional District,Joseph Henderson (M),DM5,"City of Plattsburgh Ward 5 2 ",0,15,0,13,28,3.48
DELEGATES TO NATIONAL CONVENTION 21st Congressional District,Joseph Henderson (M),DM5,"City of Plattsburgh Ward 6 1 ",0,15,0,11,26,3.85
DELEGATES TO NATIONAL CONVENTION 21st Congressional District,Joseph Henderson (M),DM5,"City of Plattsburgh Ward 6 2 ",0,10,0,11,21,6.40
DELEGATES TO NATIONAL CONVENTION 21st Congressional District,Joseph Henderson (M),DM5,"Town of Altona 1 ",0,17,0,4,21,5.06
DELEGATES TO NATIONAL CONVENTION 21st Congressional District,Joseph Henderson (M),DM5,"Town of AuSable 1 ",0,3,0,3,6,2.41
DELEGATES TO NATIONAL CONVENTION 21st Congressional District,Joseph Henderson (M),DM5,"Town of AuSable 2 ",0,7,0,1,8,3.01
DELEGATES TO NATIONAL CONVENTION 21st Congressional District,Joseph Henderson (M),DM5,"Town of Beekmantown 1 ",0,6,0,3,9,2.49
DELEGATES TO NATIONAL CONVENTION 21st Congressional District,Joseph Henderson (M),DM5,"Town of Beekmantown 2 ",0,7,0,6,13,4.28
DELEGATES TO NATIONAL CONVENTION 21st Congressional District,Joseph Henderson (M),DM5,"Town of Beekmantown 3 ",0,13,0,11,24,3.21
DELEGATES TO NATIONAL CONVENTION 21st Congressional District,Joseph Henderson (M),DM5,"Town of Beekmantown 4 ",0,5,0,3,8,2.08
DELEGATES TO NATIONAL CONVENTION 21st Congressional District,Joseph Henderson (M),DM5,"Town of Black Brook 1 ",0,1,0,2,3,1.12
DELEGATES TO NATIONAL CONVENTION 21st Congressional District,Joseph Henderson (M),DM5,"Town of Black Brook 2 ",0,3,0,2,5,5.21
DELEGATES TO NATIONAL CONVENTION 21st Congressional District,Joseph Henderson (M),DM5,"Town of Champlain 1 ",0,9,0,4,13,3.37
DELEGATES TO NATIONAL CONVENTION 21st Congressional District,Joseph Henderson (M),DM5,"Town of Champlain 2 ",0,11,0,2,13,2.46
DELEGATES TO NATIONAL CONVENTION 21st Congressional District,Joseph Henderson (M),DM5,"Town of Champlain 3 ",0,9,0,11,20,4.48
DELEGATES TO NATIONAL CONVENTION 21st Congressional District,Joseph Henderson (M),DM5,"Town of Chazy 1 ",0,13,0,5,18,3.54
DELEGATES TO NATIONAL CONVENTION 21st Congressional District,Joseph Henderson (M),DM5,"Town of Chazy 2 ",0,12,0,2,14,3.18
DELEGATES TO NATIONAL CONVENTION 21st Congressional District,Joseph Henderson (M),DM5,"Town of Clinton 1 ",0,4,0,2,6,5.71
DELEGATES TO NATIONAL CONVENTION 21st Congressional District,Joseph Henderson (M),DM5,"Town of Dannemora 1 ",0,0,0,0,0,0.00
DELEGATES TO NATIONAL CONVENTION 21st Congressional District,Joseph Henderson (M),DM5,"Town of Dannemora 2 ",0,1,0,1,2,1.59
DELEGATES TO NATIONAL CONVENTION 21st Congressional District,Joseph Henderson (M),DM5,"Town of Dannemora 3 ",0,1,0,1,2,1.09
DELEGATES TO NATIONAL CONVENTION 21st Congressional District,Joseph Henderson (M),DM5,"Town of Ellenburg 1 ",0,8,0,0,8,2.25
DELEGATES TO NATIONAL CONVENTION 21st Congressional District,Joseph Henderson (M),DM5,"Town of Mooers 1 ",0,4,0,3,7,2.09
DELEGATES TO NATIONAL CONVENTION 21st Congressional District,Joseph Henderson (M),DM5,"Town of Mooers 2 ",0,3,0,0,3,2.14
DELEGATES TO NATIONAL CONVENTION 21st Congressional District,Joseph Henderson (M),DM5,"Town of Peru 1 ",0,9,0,1,10,2.68
DELEGATES TO NATIONAL CONVENTION 21st Congressional District,Joseph Henderson (M),DM5,"Town of Peru 2 ",0,14,0,8,22,4.03
DELEGATES TO NATIONAL CONVENTION 21st Congressional District,Joseph Henderson (M),DM5,"Town of Peru 3 ",0,8,0,1,9,4.52
DELEGATES TO NATIONAL CONVENTION 21st Congressional District,Joseph Henderson (M),DM5,"Town of Peru 4 ",0,8,0,6,14,2.60
DELEGATES TO NATIONAL CONVENTION 21st Congressional District,Joseph Henderson (M),DM5,"Town of Plattsburgh 1 ",0,6,0,5,11,2.95
DELEGATES TO NATIONAL CONVENTION 21st Congressional District,Joseph Henderson (M),DM5,"Town of Plattsburgh 2 ",0,17,0,0,17,3.53
DELEGATES TO NATIONAL CONVENTION 21st Congressional District,Joseph Henderson (M),DM5,"Town of Plattsburgh 3 ",0,13,0,9,22,3.34
DELEGATES TO NATIONAL CONVENTION 21st Congressional District,Joseph Henderson (M),DM5,"Town of Plattsburgh 4 ",0,5,0,5,10,2.47
DELEGATES TO NATIONAL CONVENTION 21st Congressional District,Joseph Henderson (M),DM5,"Town of Plattsburgh 5 ",0,13,0,1,14,4.59
DELEGATES TO NATIONAL CONVENTION 21st Congressional District,Joseph Henderson (M),DM5,"Town of Plattsburgh 6 ",0,18,0,10,28,3.11
DELEGATES TO NATIONAL CONVENTION 21st Congressional District,Joseph Henderson (M),DM5,"Town of Plattsburgh 7 ",0,7,0,8,15,4.32
DELEGATES TO NATIONAL CONVENTION 21st Congressional District,Joseph Henderson (M),DM5,"Town of Saranac 1 ",0,10,0,2,12,2.74
DELEGATES TO NATIONAL CONVENTION 21st Congressional District,Joseph Henderson (M),DM5,"Town of Saranac 2 ",0,6,0,5,11,4.47
DELEGATES TO NATIONAL CONVENTION 21st Congressional District,Joseph Henderson (M),DM5,"Town of Saranac 3 ",0,3,0,4,7,3.37
DELEGATES TO NATIONAL CONVENTION 21st Congressional District,Joseph Henderson (M),DM5,"Town of Schuyler Falls 1 ",0,8,0,1,9,5.66
DELEGATES TO NATIONAL CONVENTION 21st Congressional District,Joseph Henderson (M),DM5,"Town of Schuyler Falls 2 ",0,10,0,3,13,2.88
DELEGATES TO NATIONAL CONVENTION 21st Congressional District,Joseph Henderson (M),DM5,"Town of Schuyler Falls 3 ",0,9,0,3,12,3.23
DELEGATES TO NATIONAL CONVENTION 21st Congressional District,Patrick Nelson (M),DM5,"City of Plattsburgh Ward 1 1 ",0,6,0,4,10,5.62
DELEGATES TO NATIONAL CONVENTION 21st Congressional District,Patrick Nelson (M),DM5,"City of Plattsburgh Ward 1 2 ",0,17,0,20,37,2.99
DELEGATES TO NATIONAL CONVENTION 21st Congressional District,Patrick Nelson (M),DM5,"City of Plattsburgh Ward 1 3 ",0,2,0,0,2,5.56
DELEGATES TO NATIONAL CONVENTION 21st Congressional District,Patrick Nelson (M),DM5,"City of Plattsburgh Ward 2 1 ",0,9,0,11,20,5.14
DELEGATES TO NATIONAL CONVENTION 21st Congressional District,Patrick Nelson (M),DM5,"City of Plattsburgh Ward 2 2 ",0,5,0,7,12,4.90
DELEGATES TO NATIONAL CONVENTION 21st Congressional District,Patrick Nelson (M),DM5,"City of Plattsburgh Ward 3 1 ",0,13,0,5,18,3.28
DELEGATES TO NATIONAL CONVENTION 21st Congressional District,Patrick Nelson (M),DM5,"City of Plattsburgh Ward 3 2 ",0,19,0,12,31,3.66
DELEGATES TO NATIONAL CONVENTION 21st Congressional District,Patrick Nelson (M),DM5,"City of Plattsburgh Ward 4 1 ",0,18,0,15,33,4.09
DELEGATES TO NATIONAL CONVENTION 21st Congressional District,Patrick Nelson (M),DM5,"City of Plattsburgh Ward 4 2 ",0,17,0,12,29,3.63
DELEGATES TO NATIONAL CONVENTION 21st Congressional District,Patrick Nelson (M),DM5,"City of Plattsburgh Ward 5 1 ",0,12,0,9,21,3.78
DELEGATES TO NATIONAL CONVENTION 21st Congressional District,Patrick Nelson (M),DM5,"City of Plattsburgh Ward 5 2 ",0,19,0,16,35,4.35
DELEGATES TO NATIONAL CONVENTION 21st Congressional District,Patrick Nelson (M),DM5,"City of Plattsburgh Ward 6 1 ",0,20,0,9,29,4.30
DELEGATES TO NATIONAL CONVENTION 21st Congressional District,Patrick Nelson (M),DM5,"City of Plattsburgh Ward 6 2 ",0,10,0,12,22,6.71
DELEGATES TO NATIONAL CONVENTION 21st Congressional District,Patrick Nelson (M),DM5,"Town of Altona 1 ",0,17,0,6,23,5.54
DELEGATES TO NATIONAL CONVENTION 21st Congressional District,Patrick Nelson (M),DM5,"Town of AuSable 1 ",0,5,0,3,8,3.21
DELEGATES TO NATIONAL CONVENTION 21st Congressional District,Patrick Nelson (M),DM5,"Town of AuSable 2 ",0,7,0,4,11,4.14
DELEGATES TO NATIONAL CONVENTION 21st Congressional District,Patrick Nelson (M),DM5,"Town of Beekmantown 1 ",0,7,0,3,10,2.76
DELEGATES TO NATIONAL CONVENTION 21st Congressional District,Patrick Nelson (M),DM5,"Town of Beekmantown 2 ",0,6,0,6,12,3.95
DELEGATES TO NATIONAL CONVENTION 21st Congressional District,Patrick Nelson (M),DM5,"Town of Beekmantown 3 ",0,16,0,11,27,3.61
DELEGATES TO NATIONAL CONVENTION 21st Congressional District,Patrick Nelson (M),DM5,"Town of Beekmantown 4 ",0,7,0,5,12,3.12
DELEGATES TO NATIONAL CONVENTION 21st Congressional District,Patrick Nelson (M),DM5,"Town of Black Brook 1 ",0,1,0,5,6,2.23
DELEGATES TO NATIONAL CONVENTION 21st Congressional District,Patrick Nelson (M),DM5,"Town of Black Brook 2 ",0,4,0,1,5,5.21
DELEGATES TO NATIONAL CONVENTION 21st Congressional District,Patrick Nelson (M),DM5,"Town of Champlain 1 ",0,12,0,3,15,3.89
DELEGATES TO NATIONAL CONVENTION 21st Congressional District,Patrick Nelson (M),DM5,"Town of Champlain 2 ",0,17,0,5,22,4.16
DELEGATES TO NATIONAL CONVENTION 21st Congressional District,Patrick Nelson (M),DM5,"Town of Champlain 3 ",0,11,0,11,22,4.93
DELEGATES TO NATIONAL CONVENTION 21st Congressional District,Patrick Nelson (M),DM5,"Town of Chazy 1 ",0,13,0,6,19,3.73
DELEGATES TO NATIONAL CONVENTION 21st Congressional District,Patrick Nelson (M),DM5,"Town of Chazy 2 ",0,16,0,3,19,4.32
DELEGATES TO NATIONAL CONVENTION 21st Congressional District,Patrick Nelson (M),DM5,"Town of Clinton 1 ",0,1,0,3,4,3.81
DELEGATES TO NATIONAL CONVENTION 21st Congressional District,Patrick Nelson (M),DM5,"Town of Dannemora 1 ",0,0,0,2,2,2.50
DELEGATES TO NATIONAL CONVENTION 21st Congressional District,Patrick Nelson (M),DM5,"Town of Dannemora 2 ",0,1,0,0,1,0.79
DELEGATES TO NATIONAL CONVENTION 21st Congressional District,Patrick Nelson (M),DM5,"Town of Dannemora 3 ",0,1,0,3,4,2.17
DELEGATES TO NATIONAL CONVENTION 21st Congressional District,Patrick Nelson (M),DM5,"Town of Ellenburg 1 ",0,6,0,0,6,1.69
DELEGATES TO NATIONAL CONVENTION 21st Congressional District,Patrick Nelson (M),DM5,"Town of Mooers 1 ",0,5,0,7,12,3.58
DELEGATES TO NATIONAL CONVENTION 21st Congressional District,Patrick Nelson (M),DM5,"Town of Mooers 2 ",0,1,0,3,4,2.86
DELEGATES TO NATIONAL CONVENTION 21st Congressional District,Patrick Nelson (M),DM5,"Town of Peru 1 ",0,12,0,2,14,3.75
DELEGATES TO NATIONAL CONVENTION 21st Congressional District,Patrick Nelson (M),DM5,"Town of Peru 2 ",0,12,0,9,21,3.85
DELEGATES TO NATIONAL CONVENTION 21st Congressional District,Patrick Nelson (M),DM5,"Town of Peru 3 ",0,8,0,2,10,5.03
DELEGATES TO NATIONAL CONVENTION 21st Congressional District,Patrick Nelson (M),DM5,"Town of Peru 4 ",0,14,0,10,24,4.46
DELEGATES TO NATIONAL CONVENTION 21st Congressional District,Patrick Nelson (M),DM5,"Town of Plattsburgh 1 ",0,7,0,4,11,2.95
DELEGATES TO NATIONAL CONVENTION 21st Congressional District,Patrick Nelson (M),DM5,"Town of Plattsburgh 2 ",0,13,0,4,17,3.53
DELEGATES TO NATIONAL CONVENTION 21st Congressional District,Patrick Nelson (M),DM5,"Town of Plattsburgh 3 ",0,16,0,13,29,4.41
DELEGATES TO NATIONAL CONVENTION 21st Congressional District,Patrick Nelson (M),DM5,"Town of Plattsburgh 4 ",0,8,0,6,14,3.46
DELEGATES TO NATIONAL CONVENTION 21st Congressional District,Patrick Nelson (M),DM5,"Town of Plattsburgh 5 ",0,10,0,3,13,4.26
DELEGATES TO NATIONAL CONVENTION 21st Congressional District,Patrick Nelson (M),DM5,"Town of Plattsburgh 6 ",0,21,0,11,32,3.56
DELEGATES TO NATIONAL CONVENTION 21st Congressional District,Patrick Nelson (M),DM5,"Town of Plattsburgh 7 ",0,9,0,8,17,4.90
DELEGATES TO NATIONAL CONVENTION 21st Congressional District,Patrick Nelson (M),DM5,"Town of Saranac 1 ",0,10,0,3,13,2.97
DELEGATES TO NATIONAL CONVENTION 21st Congressional District,Patrick Nelson (M),DM5,"Town of Saranac 2 ",0,5,0,4,9,3.66
DELEGATES TO NATIONAL CONVENTION 21st Congressional District,Patrick Nelson (M),DM5,"Town of Saranac 3 ",0,4,0,5,9,4.33
DELEGATES TO NATIONAL CONVENTION 21st Congressional District,Patrick Nelson (M),DM5,"Town of Schuyler Falls 1 ",0,5,0,0,5,3.14
DELEGATES TO NATIONAL CONVENTION 21st Congressional District,Patrick Nelson (M),DM5,"Town of Schuyler Falls 2 ",0,12,0,6,18,3.98
DELEGATES TO NATIONAL CONVENTION 21st Congressional District,Patrick Nelson (M),DM5,"Town of Schuyler Falls 3 ",0,12,0,3,15,4.04
DELEGATES TO NATIONAL CONVENTION 21st Congressional District,Jennifer Zhang (F),DM9,"City of Plattsburgh Ward 1 1 ",0,2,0,2,4,2.25
DELEGATES TO NATIONAL CONVENTION 21st Congressional District,Jennifer Zhang (F),DM9,"City of Plattsburgh Ward 1 2 ",0,26,0,8,34,2.75
DELEGATES TO NATIONAL CONVENTION 21st Congressional District,Jennifer Zhang (F),DM9,"City of Plattsburgh Ward 1 3 ",0,1,0,0,1,2.78
DELEGATES TO NATIONAL CONVENTION 21st Congressional District,Jennifer Zhang (F),DM9,"City of Plattsburgh Ward 2 1 ",0,3,0,3,6,1.54
DELEGATES TO NATIONAL CONVENTION 21st Congressional District,Jennifer Zhang (F),DM9,"City of Plattsburgh Ward 2 2 ",0,3,0,4,7,2.86
DELEGATES TO NATIONAL CONVENTION 21st Congressional District,Jennifer Zhang (F),DM9,"City of Plattsburgh Ward 3 1 ",0,11,0,4,15,2.73
DELEGATES TO NATIONAL CONVENTION 21st Congressional District,Jennifer Zhang (F),DM9,"City of Plattsburgh Ward 3 2 ",0,15,0,8,23,2.72
DELEGATES TO NATIONAL CONVENTION 21st Congressional District,Jennifer Zhang (F),DM9,"City of Plattsburgh Ward 4 1 ",0,13,0,10,23,2.85
DELEGATES TO NATIONAL CONVENTION 21st Congressional District,Jennifer Zhang (F),DM9,"City of Plattsburgh Ward 4 2 ",0,13,0,8,21,2.63
DELEGATES TO NATIONAL CONVENTION 21st Congressional District,Jennifer Zhang (F),DM9,"City of Plattsburgh Ward 5 1 ",0,14,0,2,16,2.88
DELEGATES TO NATIONAL CONVENTION 21st Congressional District,Jennifer Zhang (F),DM9,"City of Plattsburgh Ward 5 2 ",0,14,0,10,24,2.99
DELEGATES TO NATIONAL CONVENTION 21st Congressional District,Jennifer Zhang (F),DM9,"City of Plattsburgh Ward 6 1 ",0,9,0,6,15,2.22
DELEGATES TO NATIONAL CONVENTION 21st Congressional District,Jennifer Zhang (F),DM9,"City of Plattsburgh Ward 6 2 ",0,6,0,3,9,2.74
DELEGATES TO NATIONAL CONVENTION 21st Congressional District,Jennifer Zhang (F),DM9,"Town of Altona 1 ",0,3,0,6,9,2.17
DELEGATES TO NATIONAL CONVENTION 21st Congressional District,Jennifer Zhang (F),DM9,"Town of AuSable 1 ",0,3,0,3,6,2.41
DELEGATES TO NATIONAL CONVENTION 21st Congressional District,Jennifer Zhang (F),DM9,"Town of AuSable 2 ",0,7,0,2,9,3.38
DELEGATES TO NATIONAL CONVENTION 21st Congressional District,Jennifer Zhang (F),DM9,"Town of Beekmantown 1 ",0,4,0,3,7,1.93
DELEGATES TO NATIONAL CONVENTION 21st Congressional District,Jennifer Zhang (F),DM9,"Town of Beekmantown 2 ",0,4,0,1,5,1.64
DELEGATES TO NATIONAL CONVENTION 21st Congressional District,Jennifer Zhang (F),DM9,"Town of Beekmantown 3 ",0,11,0,3,14,1.87
DELEGATES TO NATIONAL CONVENTION 21st Congressional District,Jennifer Zhang (F),DM9,"Town of Beekmantown 4 ",0,8,0,2,10,2.60
DELEGATES TO NATIONAL CONVENTION 21st Congressional District,Jennifer Zhang (F),DM9,"Town of Black Brook 1 ",0,5,0,2,7,2.60
DELEGATES TO NATIONAL CONVENTION 21st Congressional District,Jennifer Zhang (F),DM9,"Town of Black Brook 2 ",0,0,0,0,0,0.00
DELEGATES TO NATIONAL CONVENTION 21st Congressional District,Jennifer Zhang (F),DM9,"Town of Champlain 1 ",0,5,0,2,7,1.81
DELEGATES TO NATIONAL CONVENTION 21st Congressional District,Jennifer Zhang (F),DM9,"Town of Champlain 2 ",0,10,0,6,16,3.02
DELEGATES TO NATIONAL CONVENTION 21st Congressional District,Jennifer Zhang (F),DM9,"Town of Champlain 3 ",0,4,0,2,6,1.35
DELEGATES TO NATIONAL CONVENTION 21st Congressional District,Jennifer Zhang (F),DM9,"Town of Chazy 1 ",0,6,0,3,9,1.77
DELEGATES TO NATIONAL CONVENTION 21st Congressional District,Jennifer Zhang (F),DM9,"Town of Chazy 2 ",0,8,0,6,14,3.18
DELEGATES TO NATIONAL CONVENTION 21st Congressional District,Jennifer Zhang (F),DM9,"Town of Clinton 1 ",0,0,0,0,0,0.00
DELEGATES TO NATIONAL CONVENTION 21st Congressional District,Jennifer Zhang (F),DM9,"Town of Dannemora 1 ",0,0,0,0,0,0.00
DELEGATES TO NATIONAL CONVENTION 21st Congressional District,Jennifer Zhang (F),DM9,"Town of Dannemora 2 ",0,0,0,1,1,0.79
DELEGATES TO NATIONAL CONVENTION 21st Congressional District,Jennifer Zhang (F),DM9,"Town of Dannemora 3 ",0,2,0,1,3,1.63
DELEGATES TO NATIONAL CONVENTION 21st Congressional District,Jennifer Zhang (F),DM9,"Town of Ellenburg 1 ",0,2,0,3,5,1.41
DELEGATES TO NATIONAL CONVENTION 21st Congressional District,Jennifer Zhang (F),DM9,"Town of Mooers 1 ",0,2,0,7,9,2.69
DELEGATES TO NATIONAL CONVENTION 21st Congressional District,Jennifer Zhang (F),DM9,"Town of Mooers 2 ",0,0,0,2,2,1.43
DELEGATES TO NATIONAL CONVENTION 21st Congressional District,Jennifer Zhang (F),DM9,"Town of Peru 1 ",0,4,0,3,7,1.88
DELEGATES TO NATIONAL CONVENTION 21st Congressional District,Jennifer Zhang (F),DM9,"Town of Peru 2 ",0,8,0,6,14,2.56
DELEGATES TO NATIONAL CONVENTION 21st Congressional District,Jennifer Zhang (F),DM9,"Town of Peru 3 ",0,0,0,2,2,1.01
DELEGATES TO NATIONAL CONVENTION 21st Congressional District,Jennifer Zhang (F),DM9,"Town of Peru 4 ",0,9,0,2,11,2.04
DELEGATES TO NATIONAL CONVENTION 21st Congressional District,Jennifer Zhang (F),DM9,"Town of Plattsburgh 1 ",0,3,0,1,4,1.07
DELEGATES TO NATIONAL CONVENTION 21st Congressional District,Jennifer Zhang (F),DM9,"Town of Plattsburgh 2 ",0,2,0,1,3,0.62
DELEGATES TO NATIONAL CONVENTION 21st Congressional District,Jennifer Zhang (F),DM9,"Town of Plattsburgh 3 ",0,6,0,4,10,1.52
DELEGATES TO NATIONAL CONVENTION 21st Congressional District,Jennifer Zhang (F),DM9,"Town of Plattsburgh 4 ",0,5,0,2,7,1.73
DELEGATES TO NATIONAL CONVENTION 21st Congressional District,Jennifer Zhang (F),DM9,"Town of Plattsburgh 5 ",0,3,0,5,8,2.62
DELEGATES TO NATIONAL CONVENTION 21st Congressional District,Jennifer Zhang (F),DM9,"Town of Plattsburgh 6 ",0,13,0,9,22,2.44
DELEGATES TO NATIONAL CONVENTION 21st Congressional District,Jennifer Zhang (F),DM9,"Town of Plattsburgh 7 ",0,5,0,3,8,2.31
DELEGATES TO NATIONAL CONVENTION 21st Congressional District,Jennifer Zhang (F),DM9,"Town of Saranac 1 ",0,7,0,3,10,2.28
DELEGATES TO NATIONAL CONVENTION 21st Congressional District,Jennifer Zhang (F),DM9,"Town of Saranac 2 ",0,2,0,2,4,1.63
DELEGATES TO NATIONAL CONVENTION 21st Congressional District,Jennifer Zhang (F),DM9,"Town of Saranac 3 ",0,1,0,1,2,0.96
DELEGATES TO NATIONAL CONVENTION 21st Congressional District,Jennifer Zhang (F),DM9,"Town of Schuyler Falls 1 ",0,0,0,1,1,0.63
DELEGATES TO NATIONAL CONVENTION 21st Congressional District,Jennifer Zhang (F),DM9,"Town of Schuyler Falls 2 ",0,12,0,2,14,3.10
DELEGATES TO NATIONAL CONVENTION 21st Congressional District,Jennifer Zhang (F),DM9,"Town of Schuyler Falls 3 ",0,3,0,5,8,2.16
DELEGATES TO NATIONAL CONVENTION 21st Congressional District,Donald C. Carlisto (M),DM9,"City of Plattsburgh Ward 1 1 ",0,3,0,0,3,1.69
DELEGATES TO NATIONAL CONVENTION 21st Congressional District,Donald C. Carlisto (M),DM9,"City of Plattsburgh Ward 1 2 ",0,10,0,2,12,0.97
DELEGATES TO NATIONAL CONVENTION 21st Congressional District,Donald C. Carlisto (M),DM9,"City of Plattsburgh Ward 1 3 ",0,3,0,0,3,8.33
DELEGATES TO NATIONAL CONVENTION 21st Congressional District,Donald C. Carlisto (M),DM9,"City of Plattsburgh Ward 2 1 ",0,1,0,1,2,0.51
DELEGATES TO NATIONAL CONVENTION 21st Congressional District,Donald C. Carlisto (M),DM9,"City of Plattsburgh Ward 2 2 ",0,0,0,1,1,0.41
DELEGATES TO NATIONAL CONVENTION 21st Congressional District,Donald C. Carlisto (M),DM9,"City of Plattsburgh Ward 3 1 ",0,4,0,2,6,1.09
DELEGATES TO NATIONAL CONVENTION 21st Congressional District,Donald C. Carlisto (M),DM9,"City of Plattsburgh Ward 3 2 ",0,8,0,2,10,1.18
DELEGATES TO NATIONAL CONVENTION 21st Congressional District,Donald C. Carlisto (M),DM9,"City of Plattsburgh Ward 4 1 ",0,4,0,3,7,0.87
DELEGATES TO NATIONAL CONVENTION 21st Congressional District,Donald C. Carlisto (M),DM9,"City of Plattsburgh Ward 4 2 ",0,2,0,3,5,0.63
DELEGATES TO NATIONAL CONVENTION 21st Congressional District,Donald C. Carlisto (M),DM9,"City of Plattsburgh Ward 5 1 ",0,5,0,0,5,0.90
DELEGATES TO NATIONAL CONVENTION 21st Congressional District,Donald C. Carlisto (M),DM9,"City of Plattsburgh Ward 5 2 ",0,2,0,2,4,0.50
DELEGATES TO NATIONAL CONVENTION 21st Congressional District,Donald C. Carlisto (M),DM9,"City of Plattsburgh Ward 6 1 ",0,4,0,3,7,1.04
DELEGATES TO NATIONAL CONVENTION 21st Congressional District,Donald C. Carlisto (M),DM9,"City of Plattsburgh Ward 6 2 ",0,1,0,0,1,0.30
DELEGATES TO NATIONAL CONVENTION 21st Congressional District,Donald C. Carlisto (M),DM9,"Town of Altona 1 ",0,0,0,2,2,0.48
DELEGATES TO NATIONAL CONVENTION 21st Congressional District,Donald C. Carlisto (M),DM9,"Town of AuSable 1 ",0,1,0,0,1,0.40
DELEGATES TO NATIONAL CONVENTION 21st Congressional District,Donald C. Carlisto (M),DM9,"Town of AuSable 2 ",0,2,0,1,3,1.13
DELEGATES TO NATIONAL CONVENTION 21st Congressional District,Donald C. Carlisto (M),DM9,"Town of Beekmantown 1 ",0,2,0,2,4,1.10
DELEGATES TO NATIONAL CONVENTION 21st Congressional District,Donald C. Carlisto (M),DM9,"Town of Beekmantown 2 ",0,4,0,0,4,1.32
DELEGATES TO NATIONAL CONVENTION 21st Congressional District,Donald C. Carlisto (M),DM9,"Town of Beekmantown 3 ",0,2,0,0,2,0.27
DELEGATES TO NATIONAL CONVENTION 21st Congressional District,Donald C. Carlisto (M),DM9,"Town of Beekmantown 4 ",0,1,0,0,1,0.26
DELEGATES TO NATIONAL CONVENTION 21st Congressional District,Donald C. Carlisto (M),DM9,"Town of Black Brook 1 ",0,3,0,1,4,1.49
DELEGATES TO NATIONAL CONVENTION 21st Congressional District,Donald C. Carlisto (M),DM9,"Town of Black Brook 2 ",0,0,0,0,0,0.00
DELEGATES TO NATIONAL CONVENTION 21st Congressional District,Donald C. Carlisto (M),DM9,"Town of Champlain 1 ",0,5,0,1,6,1.55
DELEGATES TO NATIONAL CONVENTION 21st Congressional District,Donald C. Carlisto (M),DM9,"Town of Champlain 2 ",0,0,0,0,0,0.00
DELEGATES TO NATIONAL CONVENTION 21st Congressional District,Donald C. Carlisto (M),DM9,"Town of Champlain 3 ",0,2,0,2,4,0.90
DELEGATES TO NATIONAL CONVENTION 21st Congressional District,Donald C. Carlisto (M),DM9,"Town of Chazy 1 ",0,2,0,2,4,0.79
DELEGATES TO NATIONAL CONVENTION 21st Congressional District,Donald C. Carlisto (M),DM9,"Town of Chazy 2 ",0,1,0,1,2,0.45
DELEGATES TO NATIONAL CONVENTION 21st Congressional District,Donald C. Carlisto (M),DM9,"Town of Clinton 1 ",0,4,0,0,4,3.81
DELEGATES TO NATIONAL CONVENTION 21st Congressional District,Donald C. Carlisto (M),DM9,"Town of Dannemora 1 ",0,0,0,0,0,0.00
DELEGATES TO NATIONAL CONVENTION 21st Congressional District,Donald C. Carlisto (M),DM9,"Town of Dannemora 2 ",0,1,0,0,1,0.79
DELEGATES TO NATIONAL CONVENTION 21st Congressional District,Donald C. Carlisto (M),DM9,"Town of Dannemora 3 ",0,0,0,1,1,0.54
DELEGATES TO NATIONAL CONVENTION 21st Congressional District,Donald C. Carlisto (M),DM9,"Town of Ellenburg 1 ",0,5,0,1,6,1.69
DELEGATES TO NATIONAL CONVENTION 21st Congressional District,Donald C. Carlisto (M),DM9,"Town of Mooers 1 ",0,3,0,3,6,1.79
DELEGATES TO NATIONAL CONVENTION 21st Congressional District,Donald C. Carlisto (M),DM9,"Town of Mooers 2 ",0,0,0,1,1,0.71
DELEGATES TO NATIONAL CONVENTION 21st Congressional District,Donald C. Carlisto (M),DM9,"Town of Peru 1 ",0,2,0,0,2,0.54
DELEGATES TO NATIONAL CONVENTION 21st Congressional District,Donald C. Carlisto (M),DM9,"Town of Peru 2 ",0,3,0,0,3,0.55
DELEGATES TO NATIONAL CONVENTION 21st Congressional District,Donald C. Carlisto (M),DM9,"Town of Peru 3 ",0,2,0,0,2,1.01
DELEGATES TO NATIONAL CONVENTION 21st Congressional District,Donald C. Carlisto (M),DM9,"Town of Peru 4 ",0,4,0,2,6,1.12
DELEGATES TO NATIONAL CONVENTION 21st Congressional District,Donald C. Carlisto (M),DM9,"Town of Plattsburgh 1 ",0,2,0,1,3,0.80
DELEGATES TO NATIONAL CONVENTION 21st Congressional District,Donald C. Carlisto (M),DM9,"Town of Plattsburgh 2 ",0,2,0,0,2,0.42
DELEGATES TO NATIONAL CONVENTION 21st Congressional District,Donald C. Carlisto (M),DM9,"Town of Plattsburgh 3 ",0,6,0,1,7,1.06
DELEGATES TO NATIONAL CONVENTION 21st Congressional District,Donald C. Carlisto (M),DM9,"Town of Plattsburgh 4 ",0,1,0,0,1,0.25
DELEGATES TO NATIONAL CONVENTION 21st Congressional District,Donald C. Carlisto (M),DM9,"Town of Plattsburgh 5 ",0,1,0,3,4,1.31
DELEGATES TO NATIONAL CONVENTION 21st Congressional District,Donald C. Carlisto (M),DM9,"Town of Plattsburgh 6 ",0,4,0,2,6,0.67
DELEGATES TO NATIONAL CONVENTION 21st Congressional District,Donald C. Carlisto (M),DM9,"Town of Plattsburgh 7 ",0,3,0,1,4,1.15
DELEGATES TO NATIONAL CONVENTION 21st Congressional District,Donald C. Carlisto (M),DM9,"Town of Saranac 1 ",0,4,0,0,4,0.91
DELEGATES TO NATIONAL CONVENTION 21st Congressional District,Donald C. Carlisto (M),DM9,"Town of Saranac 2 ",0,0,0,1,1,0.41
DELEGATES TO NATIONAL CONVENTION 21st Congressional District,Donald C. Carlisto (M),DM9,"Town of Saranac 3 ",0,2,0,0,2,0.96
DELEGATES TO NATIONAL CONVENTION 21st Congressional District,Donald C. Carlisto (M),DM9,"Town of Schuyler Falls 1 ",0,1,0,1,2,1.26
DELEGATES TO NATIONAL CONVENTION 21st Congressional District,Donald C. Carlisto (M),DM9,"Town of Schuyler Falls 2 ",0,3,0,2,5,1.11
DELEGATES TO NATIONAL CONVENTION 21st Congressional District,Donald C. Carlisto (M),DM9,"Town of Schuyler Falls 3 ",0,3,0,0,3,0.81
DELEGATES TO NATIONAL CONVENTION 21st Congressional District,Christine M. Mooney (F),DM9,"City of Plattsburgh Ward 1 1 ",0,6,0,3,9,5.06
DELEGATES TO NATIONAL CONVENTION 21st Congressional District,Christine M. Mooney (F),DM9,"City of Plattsburgh Ward 1 2 ",0,23,0,7,30,2.42
DELEGATES TO NATIONAL CONVENTION 21st Congressional District,Christine M. Mooney (F),DM9,"City of Plattsburgh Ward 1 3 ",0,1,0,0,1,2.78
DELEGATES TO NATIONAL CONVENTION 21st Congressional District,Christine M. Mooney (F),DM9,"City of Plattsburgh Ward 2 1 ",0,2,0,4,6,1.54
DELEGATES TO NATIONAL CONVENTION 21st Congressional District,Christine M. Mooney (F),DM9,"City of Plattsburgh Ward 2 2 ",0,2,0,4,6,2.45
DELEGATES TO NATIONAL CONVENTION 21st Congressional District,Christine M. Mooney (F),DM9,"City of Plattsburgh Ward 3 1 ",0,11,0,4,15,2.73
DELEGATES TO NATIONAL CONVENTION 21st Congressional District,Christine M. Mooney (F),DM9,"City of Plattsburgh Ward 3 2 ",0,10,0,4,14,1.65
DELEGATES TO NATIONAL CONVENTION 21st Congressional District,Christine M. Mooney (F),DM9,"City of Plattsburgh Ward 4 1 ",0,14,0,15,29,3.60
DELEGATES TO NATIONAL CONVENTION 21st Congressional District,Christine M. Mooney (F),DM9,"City of Plattsburgh Ward 4 2 ",0,9,0,5,14,1.75
DELEGATES TO NATIONAL CONVENTION 21st Congressional District,Christine M. Mooney (F),DM9,"City of Plattsburgh Ward 5 1 ",0,12,0,4,16,2.88
DELEGATES TO NATIONAL CONVENTION 21st Congressional District,Christine M. Mooney (F),DM9,"City of Plattsburgh Ward 5 2 ",0,17,0,5,22,2.74
DELEGATES TO NATIONAL CONVENTION 21st Congressional District,Christine M. Mooney (F),DM9,"City of Plattsburgh Ward 6 1 ",0,8,0,11,19,2.81
DELEGATES TO NATIONAL CONVENTION 21st Congressional District,Christine M. Mooney (F),DM9,"City of Plattsburgh Ward 6 2 ",0,2,0,1,3,0.91
DELEGATES TO NATIONAL CONVENTION 21st Congressional District,Christine M. Mooney (F),DM9,"Town of Altona 1 ",0,7,0,7,14,3.37
DELEGATES TO NATIONAL CONVENTION 21st Congressional District,Christine M. Mooney (F),DM9,"Town of AuSable 1 ",0,2,0,2,4,1.61
DELEGATES TO NATIONAL CONVENTION 21st Congressional District,Christine M. Mooney (F),DM9,"Town of AuSable 2 ",0,4,0,1,5,1.88
DELEGATES TO NATIONAL CONVENTION 21st Congressional District,Christine M. Mooney (F),DM9,"Town of Beekmantown 1 ",0,6,0,4,10,2.76
DELEGATES TO NATIONAL CONVENTION 21st Congressional District,Christine M. Mooney (F),DM9,"Town of Beekmantown 2 ",0,3,0,3,6,1.97
DELEGATES TO NATIONAL CONVENTION 21st Congressional District,Christine M. Mooney (F),DM9,"Town of Beekmantown 3 ",0,12,0,3,15,2.01
DELEGATES TO NATIONAL CONVENTION 21st Congressional District,Christine M. Mooney (F),DM9,"Town of Beekmantown 4 ",0,4,0,2,6,1.56
DELEGATES TO NATIONAL CONVENTION 21st Congressional District,Christine M. Mooney (F),DM9,"Town of Black Brook 1 ",0,4,0,2,6,2.23
DELEGATES TO NATIONAL CONVENTION 21st Congressional District,Christine M. Mooney (F),DM9,"Town of Black Brook 2 ",0,1,0,0,1,1.04
DELEGATES TO NATIONAL CONVENTION 21st Congressional District,Christine M. Mooney (F),DM9,"Town of Champlain 1 ",0,10,0,5,15,3.89
DELEGATES TO NATIONAL CONVENTION 21st Congressional District,Christine M. Mooney (F),DM9,"Town of Champlain 2 ",0,7,0,4,11,2.08
DELEGATES TO NATIONAL CONVENTION 21st Congressional District,Christine M. Mooney (F),DM9,"Town of Champlain 3 ",0,6,0,6,12,2.69
DELEGATES TO NATIONAL CONVENTION 21st Congressional District,Christine M. Mooney (F),DM9,"Town of Chazy 1 ",0,5,0,5,10,1.96
DELEGATES TO NATIONAL CONVENTION 21st Congressional District,Christine M. Mooney (F),DM9,"Town of Chazy 2 ",0,16,0,4,20,4.55
DELEGATES TO NATIONAL CONVENTION 21st Congressional District,Christine M. Mooney (F),DM9,"Town of Clinton 1 ",0,2,0,0,2,1.90
DELEGATES TO NATIONAL CONVENTION 21st Congressional District,Christine M. Mooney (F),DM9,"Town of Dannemora 1 ",0,0,0,1,1,1.25
DELEGATES TO NATIONAL CONVENTION 21st Congressional District,Christine M. Mooney (F),DM9,"Town of Dannemora 2 ",0,1,0,1,2,1.59
DELEGATES TO NATIONAL CONVENTION 21st Congressional District,Christine M. Mooney (F),DM9,"Town of Dannemora 3 ",0,0,0,1,1,0.54
DELEGATES TO NATIONAL CONVENTION 21st Congressional District,Christine M. Mooney (F),DM9,"Town of Ellenburg 1 ",0,12,0,4,16,4.51
DELEGATES TO NATIONAL CONVENTION 21st Congressional District,Christine M. Mooney (F),DM9,"Town of Mooers 1 ",0,5,0,6,11,3.28
DELEGATES TO NATIONAL CONVENTION 21st Congressional District,Christine M. Mooney (F),DM9,"Town of Mooers 2 ",0,2,0,2,4,2.86
DELEGATES TO NATIONAL CONVENTION 21st Congressional District,Christine M. Mooney (F),DM9,"Town of Peru 1 ",0,3,0,3,6,1.61
DELEGATES TO NATIONAL CONVENTION 21st Congressional District,Christine M. Mooney (F),DM9,"Town of Peru 2 ",0,4,0,2,6,1.10
DELEGATES TO NATIONAL CONVENTION 21st Congressional District,Christine M. Mooney (F),DM9,"Town of Peru 3 ",0,4,0,1,5,2.51
DELEGATES TO NATIONAL CONVENTION 21st Congressional District,Christine M. Mooney (F),DM9,"Town of Peru 4 ",0,7,0,3,10,1.86
DELEGATES TO NATIONAL CONVENTION 21st Congressional District,Christine M. Mooney (F),DM9,"Town of Plattsburgh 1 ",0,4,0,2,6,1.61
DELEGATES TO NATIONAL CONVENTION 21st Congressional District,Christine M. Mooney (F),DM9,"Town of Plattsburgh 2 ",0,4,0,1,5,1.04
DELEGATES TO NATIONAL CONVENTION 21st Congressional District,Christine M. Mooney (F),DM9,"Town of Plattsburgh 3 ",0,8,0,5,13,1.98
DELEGATES TO NATIONAL CONVENTION 21st Congressional District,Christine M. Mooney (F),DM9,"Town of Plattsburgh 4 ",0,6,0,2,8,1.98
DELEGATES TO NATIONAL CONVENTION 21st Congressional District,Christine M. Mooney (F),DM9,"Town of Plattsburgh 5 ",0,3,0,5,8,2.62
DELEGATES TO NATIONAL CONVENTION 21st Congressional District,Christine M. Mooney (F),DM9,"Town of Plattsburgh 6 ",0,6,0,5,11,1.22
DELEGATES TO NATIONAL CONVENTION 21st Congressional District,Christine M. Mooney (F),DM9,"Town of Plattsburgh 7 ",0,6,0,3,9,2.59
DELEGATES TO NATIONAL CONVENTION 21st Congressional District,Christine M. Mooney (F),DM9,"Town of Saranac 1 ",0,3,0,2,5,1.14
DELEGATES TO NATIONAL CONVENTION 21st Congressional District,Christine M. Mooney (F),DM9,"Town of Saranac 2 ",0,2,0,2,4,1.63
DELEGATES TO NATIONAL CONVENTION 21st Congressional District,Christine M. Mooney (F),DM9,"Town of Saranac 3 ",0,3,0,2,5,2.40
DELEGATES TO NATIONAL CONVENTION 21st Congressional District,Christine M. Mooney (F),DM9,"Town of Schuyler Falls 1 ",0,5,0,1,6,3.77
DELEGATES TO NATIONAL CONVENTION 21st Congressional District,Christine M. Mooney (F),DM9,"Town of Schuyler Falls 2 ",0,5,0,2,7,1.55
DELEGATES TO NATIONAL CONVENTION 21st Congressional District,Christine M. Mooney (F),DM9,"Town of Schuyler Falls 3 ",0,4,0,3,7,1.89
DELEGATES TO NATIONAL CONVENTION 21st Congressional District,Jackson P. Lasarso (M),DM9,"City of Plattsburgh Ward 1 1 ",0,2,0,2,4,2.25
DELEGATES TO NATIONAL CONVENTION 21st Congressional District,Jackson P. Lasarso (M),DM9,"City of Plattsburgh Ward 1 2 ",0,9,0,2,11,0.89
DELEGATES TO NATIONAL CONVENTION 21st Congressional District,Jackson P. Lasarso (M),DM9,"City of Plattsburgh Ward 1 3 ",0,0,0,0,0,0.00
DELEGATES TO NATIONAL CONVENTION 21st Congressional District,Jackson P. Lasarso (M),DM9,"City of Plattsburgh Ward 2 1 ",0,1,0,0,1,0.26
DELEGATES TO NATIONAL CONVENTION 21st Congressional District,Jackson P. Lasarso (M),DM9,"City of Plattsburgh Ward 2 2 ",0,1,0,1,2,0.82
DELEGATES TO NATIONAL CONVENTION 21st Congressional District,Jackson P. Lasarso (M),DM9,"City of Plattsburgh Ward 3 1 ",0,4,0,2,6,1.09
DELEGATES TO NATIONAL CONVENTION 21st Congressional District,Jackson P. Lasarso (M),DM9,"City of Plattsburgh Ward 3 2 ",0,5,0,0,5,0.59
DELEGATES TO NATIONAL CONVENTION 21st Congressional District,Jackson P. Lasarso (M),DM9,"City of Plattsburgh Ward 4 1 ",0,2,0,1,3,0.37
DELEGATES TO NATIONAL CONVENTION 21st Congressional District,Jackson P. Lasarso (M),DM9,"City of Plattsburgh Ward 4 2 ",0,4,0,3,7,0.88
DELEGATES TO NATIONAL CONVENTION 21st Congressional District,Jackson P. Lasarso (M),DM9,"City of Plattsburgh Ward 5 1 ",0,9,0,1,10,1.80
DELEGATES TO NATIONAL CONVENTION 21st Congressional District,Jackson P. Lasarso (M),DM9,"City of Plattsburgh Ward 5 2 ",0,6,0,2,8,1.00
DELEGATES TO NATIONAL CONVENTION 21st Congressional District,Jackson P. Lasarso (M),DM9,"City of Plattsburgh Ward 6 1 ",0,3,0,3,6,0.89
DELEGATES TO NATIONAL CONVENTION 21st Congressional District,Jackson P. Lasarso (M),DM9,"City of Plattsburgh Ward 6 2 ",0,2,0,0,2,0.61
DELEGATES TO NATIONAL CONVENTION 21st Congressional District,Jackson P. Lasarso (M),DM9,"Town of Altona 1 ",0,2,0,3,5,1.20
DELEGATES TO NATIONAL CONVENTION 21st Congressional District,Jackson P. Lasarso (M),DM9,"Town of AuSable 1 ",0,0,0,0,0,0.00
DELEGATES TO NATIONAL CONVENTION 21st Congressional District,Jackson P. Lasarso (M),DM9,"Town of AuSable 2 ",0,3,0,2,5,1.88
DELEGATES TO NATIONAL CONVENTION 21st Congressional District,Jackson P. Lasarso (M),DM9,"Town of Beekmantown 1 ",0,1,0,1,2,0.55
DELEGATES TO NATIONAL CONVENTION 21st Congressional District,Jackson P. Lasarso (M),DM9,"Town of Beekmantown 2 ",0,0,0,1,1,0.33
DELEGATES TO NATIONAL CONVENTION 21st Congressional District,Jackson P. Lasarso (M),DM9,"Town of Beekmantown 3 ",0,2,0,0,2,0.27
DELEGATES TO NATIONAL CONVENTION 21st Congressional District,Jackson P. Lasarso (M),DM9,"Town of Beekmantown 4 ",0,2,0,1,3,0.78
DELEGATES TO NATIONAL CONVENTION 21st Congressional District,Jackson P. Lasarso (M),DM9,"Town of Black Brook 1 ",0,4,0,2,6,2.23
DELEGATES TO NATIONAL CONVENTION 21st Congressional District,Jackson P. Lasarso (M),DM9,"Town of Black Brook 2 ",0,0,0,0,0,0.00
DELEGATES TO NATIONAL CONVENTION 21st Congressional District,Jackson P. Lasarso (M),DM9,"Town of Champlain 1 ",0,3,0,0,3,0.78
DELEGATES TO NATIONAL CONVENTION 21st Congressional District,Jackson P. Lasarso (M),DM9,"Town of Champlain 2 ",0,0,0,2,2,0.38
DELEGATES TO NATIONAL CONVENTION 21st Congressional District,Jackson P. Lasarso (M),DM9,"Town of Champlain 3 ",0,3,0,0,3,0.67
DELEGATES TO NATIONAL CONVENTION 21st Congressional District,Jackson P. Lasarso (M),DM9,"Town of Chazy 1 ",0,4,0,2,6,1.18
DELEGATES TO NATIONAL CONVENTION 21st Congressional District,Jackson P. Lasarso (M),DM9,"Town of Chazy 2 ",0,3,0,1,4,0.91
DELEGATES TO NATIONAL CONVENTION 21st Congressional District,Jackson P. Lasarso (M),DM9,"Town of Clinton 1 ",0,0,0,0,0,0.00
DELEGATES TO NATIONAL CONVENTION 21st Congressional District,Jackson P. Lasarso (M),DM9,"Town of Dannemora 1 ",0,0,0,1,1,1.25
DELEGATES TO NATIONAL CONVENTION 21st Congressional District,Jackson P. Lasarso (M),DM9,"Town of Dannemora 2 ",0,0,0,0,0,0.00
DELEGATES TO NATIONAL CONVENTION 21st Congressional District,Jackson P. Lasarso (M),DM9,"Town of Dannemora 3 ",0,0,0,0,0,0.00
DELEGATES TO NATIONAL CONVENTION 21st Congressional District,Jackson P. Lasarso (M),DM9,"Town of Ellenburg 1 ",0,0,0,1,1,0.28
DELEGATES TO NATIONAL CONVENTION 21st Congressional District,Jackson P. Lasarso (M),DM9,"Town of Mooers 1 ",0,2,0,2,4,1.19
DELEGATES TO NATIONAL CONVENTION 21st Congressional District,Jackson P. Lasarso (M),DM9,"Town of Mooers 2 ",0,0,0,0,0,0.00
DELEGATES TO NATIONAL CONVENTION 21st Congressional District,Jackson P. Lasarso (M),DM9,"Town of Peru 1 ",0,3,0,1,4,1.07
DELEGATES TO NATIONAL CONVENTION 21st Congressional District,Jackson P. Lasarso (M),DM9,"Town of Peru 2 ",0,1,0,2,3,0.55
DELEGATES TO NATIONAL CONVENTION 21st Congressional District,Jackson P. Lasarso (M),DM9,"Town of Peru 3 ",0,0,0,0,0,0.00
DELEGATES TO NATIONAL CONVENTION 21st Congressional District,Jackson P. Lasarso (M),DM9,"Town of Peru 4 ",0,1,0,1,2,0.37
DELEGATES TO NATIONAL CONVENTION 21st Congressional District,Jackson P. Lasarso (M),DM9,"Town of Plattsburgh 1 ",0,1,0,0,1,0.27
DELEGATES TO NATIONAL CONVENTION 21st Congressional District,Jackson P. Lasarso (M),DM9,"Town of Plattsburgh 2 ",0,1,0,0,1,0.21
DELEGATES TO NATIONAL CONVENTION 21st Congressional District,Jackson P. Lasarso (M),DM9,"Town of Plattsburgh 3 ",0,2,0,1,3,0.46
DELEGATES TO NATIONAL CONVENTION 21st Congressional District,Jackson P. Lasarso (M),DM9,"Town of Plattsburgh 4 ",0,2,0,1,3,0.74
DELEGATES TO NATIONAL CONVENTION 21st Congressional District,Jackson P. Lasarso (M),DM9,"Town of Plattsburgh 5 ",0,1,0,2,3,0.98
DELEGATES TO NATIONAL CONVENTION 21st Congressional District,Jackson P. Lasarso (M),DM9,"Town of Plattsburgh 6 ",0,2,0,1,3,0.33
DELEGATES TO NATIONAL CONVENTION 21st Congressional District,Jackson P. Lasarso (M),DM9,"Town of Plattsburgh 7 ",0,1,0,1,2,0.58
DELEGATES TO NATIONAL CONVENTION 21st Congressional District,Jackson P. Lasarso (M),DM9,"Town of Saranac 1 ",0,3,0,1,4,0.91
DELEGATES TO NATIONAL CONVENTION 21st Congressional District,Jackson P. Lasarso (M),DM9,"Town of Saranac 2 ",0,1,0,1,2,0.81
DELEGATES TO NATIONAL CONVENTION 21st Congressional District,Jackson P. Lasarso (M),DM9,"Town of Saranac 3 ",0,1,0,1,2,0.96
DELEGATES TO NATIONAL CONVENTION 21st Congressional District,Jackson P. Lasarso (M),DM9,"Town of Schuyler Falls 1 ",0,0,0,0,0,0.00
DELEGATES TO NATIONAL CONVENTION 21st Congressional District,Jackson P. Lasarso (M),DM9,"Town of Schuyler Falls 2 ",0,2,0,0,2,0.44
DELEGATES TO NATIONAL CONVENTION 21st Congressional District,Jackson P. Lasarso (M),DM9,"Town of Schuyler Falls 3 ",0,0,0,0,0,0.00
DELEGATES TO NATIONAL CONVENTION 21st Congressional District,Darlene M. Hayes (F),DM9,"City of Plattsburgh Ward 1 1 ",0,2,0,0,2,1.12
DELEGATES TO NATIONAL CONVENTION 21st Congressional District,Darlene M. Hayes (F),DM9,"City of Plattsburgh Ward 1 2 ",0,18,0,3,21,1.70
DELEGATES TO NATIONAL CONVENTION 21st Congressional District,Darlene M. Hayes (F),DM9,"City of Plattsburgh Ward 1 3 ",0,0,0,0,0,0.00
DELEGATES TO NATIONAL CONVENTION 21st Congressional District,Darlene M. Hayes (F),DM9,"City of Plattsburgh Ward 2 1 ",0,1,0,1,2,0.51
DELEGATES TO NATIONAL CONVENTION 21st Congressional District,Darlene M. Hayes (F),DM9,"City of Plattsburgh Ward 2 2 ",0,2,0,1,3,1.22
DELEGATES TO NATIONAL CONVENTION 21st Congressional District,Darlene M. Hayes (F),DM9,"City of Plattsburgh Ward 3 1 ",0,7,0,2,9,1.64
DELEGATES TO NATIONAL CONVENTION 21st Congressional District,Darlene M. Hayes (F),DM9,"City of Plattsburgh Ward 3 2 ",0,8,0,3,11,1.30
DELEGATES TO NATIONAL CONVENTION 21st Congressional District,Darlene M. Hayes (F),DM9,"City of Plattsburgh Ward 4 1 ",0,5,0,10,15,1.86
DELEGATES TO NATIONAL CONVENTION 21st Congressional District,Darlene M. Hayes (F),DM9,"City of Plattsburgh Ward 4 2 ",0,5,0,5,10,1.25
DELEGATES TO NATIONAL CONVENTION 21st Congressional District,Darlene M. Hayes (F),DM9,"City of Plattsburgh Ward 5 1 ",0,8,0,1,9,1.62
DELEGATES TO NATIONAL CONVENTION 21st Congressional District,Darlene M. Hayes (F),DM9,"City of Plattsburgh Ward 5 2 ",0,10,0,1,11,1.37
DELEGATES TO NATIONAL CONVENTION 21st Congressional District,Darlene M. Hayes (F),DM9,"City of Plattsburgh Ward 6 1 ",0,9,0,7,16,2.37
DELEGATES TO NATIONAL CONVENTION 21st Congressional District,Darlene M. Hayes (F),DM9,"City of Plattsburgh Ward 6 2 ",0,2,0,2,4,1.22
DELEGATES TO NATIONAL CONVENTION 21st Congressional District,Darlene M. Hayes (F),DM9,"Town of Altona 1 ",0,5,0,4,9,2.17
DELEGATES TO NATIONAL CONVENTION 21st Congressional District,Darlene M. Hayes (F),DM9,"Town of AuSable 1 ",0,2,0,2,4,1.61
DELEGATES TO NATIONAL CONVENTION 21st Congressional District,Darlene M. Hayes (F),DM9,"Town of AuSable 2 ",0,3,0,1,4,1.50
DELEGATES TO NATIONAL CONVENTION 21st Congressional District,Darlene M. Hayes (F),DM9,"Town of Beekmantown 1 ",0,4,0,6,10,2.76
DELEGATES TO NATIONAL CONVENTION 21st Congressional District,Darlene M. Hayes (F),DM9,"Town of Beekmantown 2 ",0,1,0,0,1,0.33
DELEGATES TO NATIONAL CONVENTION 21st Congressional District,Darlene M. Hayes (F),DM9,"Town of Beekmantown 3 ",0,6,0,2,8,1.07
DELEGATES TO NATIONAL CONVENTION 21st Congressional District,Darlene M. Hayes (F),DM9,"Town of Beekmantown 4 ",0,4,0,1,5,1.30
DELEGATES TO NATIONAL CONVENTION 21st Congressional District,Darlene M. Hayes (F),DM9,"Town of Black Brook 1 ",0,6,0,1,7,2.60
DELEGATES TO NATIONAL CONVENTION 21st Congressional District,Darlene M. Hayes (F),DM9,"Town of Black Brook 2 ",0,0,0,0,0,0.00
DELEGATES TO NATIONAL CONVENTION 21st Congressional District,Darlene M. Hayes (F),DM9,"Town of Champlain 1 ",0,5,0,2,7,1.81
DELEGATES TO NATIONAL CONVENTION 21st Congressional District,Darlene M. Hayes (F),DM9,"Town of Champlain 2 ",0,4,0,2,6,1.13
DELEGATES TO NATIONAL CONVENTION 21st Congressional District,Darlene M. Hayes (F),DM9,"Town of Champlain 3 ",0,3,0,4,7,1.57
DELEGATES TO NATIONAL CONVENTION 21st Congressional District,Darlene M. Hayes (F),DM9,"Town of Chazy 1 ",0,2,0,3,5,0.98
DELEGATES TO NATIONAL CONVENTION 21st Congressional District,Darlene M. Hayes (F),DM9,"Town of Chazy 2 ",0,7,0,2,9,2.05
DELEGATES TO NATIONAL CONVENTION 21st Congressional District,Darlene M. Hayes (F),DM9,"Town of Clinton 1 ",0,0,0,0,0,0.00
DELEGATES TO NATIONAL CONVENTION 21st Congressional District,Darlene M. Hayes (F),DM9,"Town of Dannemora 1 ",0,0,0,0,0,0.00
DELEGATES TO NATIONAL CONVENTION 21st Congressional District,Darlene M. Hayes (F),DM9,"Town of Dannemora 2 ",0,0,0,1,1,0.79
DELEGATES TO NATIONAL CONVENTION 21st Congressional District,Darlene M. Hayes (F),DM9,"Town of Dannemora 3 ",0,0,0,0,0,0.00
DELEGATES TO NATIONAL CONVENTION 21st Congressional District,Darlene M. Hayes (F),DM9,"Town of Ellenburg 1 ",0,3,0,0,3,0.85
DELEGATES TO NATIONAL CONVENTION 21st Congressional District,Darlene M. Hayes (F),DM9,"Town of Mooers 1 ",0,1,0,3,4,1.19
DELEGATES TO NATIONAL CONVENTION 21st Congressional District,Darlene M. Hayes (F),DM9,"Town of Mooers 2 ",0,0,0,0,0,0.00
DELEGATES TO NATIONAL CONVENTION 21st Congressional District,Darlene M. Hayes (F),DM9,"Town of Peru 1 ",0,3,0,2,5,1.34
DELEGATES TO NATIONAL CONVENTION 21st Congressional District,Darlene M. Hayes (F),DM9,"Town of Peru 2 ",0,3,0,1,4,0.73
DELEGATES TO NATIONAL CONVENTION 21st Congressional District,Darlene M. Hayes (F),DM9,"Town of Peru 3 ",0,1,0,0,1,0.50
DELEGATES TO NATIONAL CONVENTION 21st Congressional District,Darlene M. Hayes (F),DM9,"Town of Peru 4 ",0,6,0,4,10,1.86
DELEGATES TO NATIONAL CONVENTION 21st Congressional District,Darlene M. Hayes (F),DM9,"Town of Plattsburgh 1 ",0,3,0,3,6,1.61
DELEGATES TO NATIONAL CONVENTION 21st Congressional District,Darlene M. Hayes (F),DM9,"Town of Plattsburgh 2 ",0,7,0,2,9,1.87
DELEGATES TO NATIONAL CONVENTION 21st Congressional District,Darlene M. Hayes (F),DM9,"Town of Plattsburgh 3 ",0,5,0,4,9,1.37
DELEGATES TO NATIONAL CONVENTION 21st Congressional District,Darlene M. Hayes (F),DM9,"Town of Plattsburgh 4 ",0,5,0,4,9,2.22
DELEGATES TO NATIONAL CONVENTION 21st Congressional District,Darlene M. Hayes (F),DM9,"Town of Plattsburgh 5 ",0,3,0,2,5,1.64
DELEGATES TO NATIONAL CONVENTION 21st Congressional District,Darlene M. Hayes (F),DM9,"Town of Plattsburgh 6 ",0,5,0,5,10,1.11
DELEGATES TO NATIONAL CONVENTION 21st Congressional District,Darlene M. Hayes (F),DM9,"Town of Plattsburgh 7 ",0,5,0,2,7,2.02
DELEGATES TO NATIONAL CONVENTION 21st Congressional District,Darlene M. Hayes (F),DM9,"Town of Saranac 1 ",0,2,0,2,4,0.91
DELEGATES TO NATIONAL CONVENTION 21st Congressional District,Darlene M. Hayes (F),DM9,"Town of Saranac 2 ",0,0,0,1,1,0.41
DELEGATES TO NATIONAL CONVENTION 21st Congressional District,Darlene M. Hayes (F),DM9,"Town of Saranac 3 ",0,1,0,1,2,0.96
DELEGATES TO NATIONAL CONVENTION 21st Congressional District,Darlene M. Hayes (F),DM9,"Town of Schuyler Falls 1 ",0,0,0,0,0,0.00
DELEGATES TO NATIONAL CONVENTION 21st Congressional District,Darlene M. Hayes (F),DM9,"Town of Schuyler Falls 2 ",0,4,0,2,6,1.33
DELEGATES TO NATIONAL CONVENTION 21st Congressional District,Darlene M. Hayes (F),DM9,"Town of Schuyler Falls 3 ",0,3,0,4,7,1.89
DELEGATES TO NATIONAL CONVENTION 21st Congressional District,Scott M. Dolan (M),DM9,"City of Plattsburgh Ward 1 1 ",0,5,0,2,7,3.93
DELEGATES TO NATIONAL CONVENTION 21st Congressional District,Scott M. Dolan (M),DM9,"City of Plattsburgh Ward 1 2 ",0,7,0,6,13,1.05
DELEGATES TO NATIONAL CONVENTION 21st Congressional District,Scott M. Dolan (M),DM9,"City of Plattsburgh Ward 1 3 ",0,0,0,0,0,0.00
DELEGATES TO NATIONAL CONVENTION 21st Congressional District,Scott M. Dolan (M),DM9,"City of Plattsburgh Ward 2 1 ",0,1,0,1,2,0.51
DELEGATES TO NATIONAL CONVENTION 21st Congressional District,Scott M. Dolan (M),DM9,"City of Plattsburgh Ward 2 2 ",0,2,0,1,3,1.22
DELEGATES TO NATIONAL CONVENTION 21st Congressional District,Scott M. Dolan (M),DM9,"City of Plattsburgh Ward 3 1 ",0,5,0,5,10,1.82
DELEGATES TO NATIONAL CONVENTION 21st Congressional District,Scott M. Dolan (M),DM9,"City of Plattsburgh Ward 3 2 ",0,5,0,2,7,0.83
DELEGATES TO NATIONAL CONVENTION 21st Congressional District,Scott M. Dolan (M),DM9,"City of Plattsburgh Ward 4 1 ",0,3,0,4,7,0.87
DELEGATES TO NATIONAL CONVENTION 21st Congressional District,Scott M. Dolan (M),DM9,"City of Plattsburgh Ward 4 2 ",0,3,0,1,4,0.50
DELEGATES TO NATIONAL CONVENTION 21st Congressional District,Scott M. Dolan (M),DM9,"City of Plattsburgh Ward 5 1 ",0,4,0,2,6,1.08
DELEGATES TO NATIONAL CONVENTION 21st Congressional District,Scott M. Dolan (M),DM9,"City of Plattsburgh Ward 5 2 ",0,2,0,1,3,0.37
DELEGATES TO NATIONAL CONVENTION 21st Congressional District,Scott M. Dolan (M),DM9,"City of Plattsburgh Ward 6 1 ",0,3,0,2,5,0.74
DELEGATES TO NATIONAL CONVENTION 21st Congressional District,Scott M. Dolan (M),DM9,"City of Plattsburgh Ward 6 2 ",0,1,0,0,1,0.30
DELEGATES TO NATIONAL CONVENTION 21st Congressional District,Scott M. Dolan (M),DM9,"Town of Altona 1 ",0,1,0,2,3,0.72
DELEGATES TO NATIONAL CONVENTION 21st Congressional District,Scott M. Dolan (M),DM9,"Town of AuSable 1 ",0,1,0,0,1,0.40
DELEGATES TO NATIONAL CONVENTION 21st Congressional District,Scott M. Dolan (M),DM9,"Town of AuSable 2 ",0,1,0,1,2,0.75
DELEGATES TO NATIONAL CONVENTION 21st Congressional District,Scott M. Dolan (M),DM9,"Town of Beekmantown 1 ",0,0,0,1,1,0.28
DELEGATES TO NATIONAL CONVENTION 21st Congressional District,Scott M. Dolan (M),DM9,"Town of Beekmantown 2 ",0,3,0,1,4,1.32
DELEGATES TO NATIONAL CONVENTION 21st Congressional District,Scott M. Dolan (M),DM9,"Town of Beekmantown 3 ",0,5,0,1,6,0.80
DELEGATES TO NATIONAL CONVENTION 21st Congressional District,Scott M. Dolan (M),DM9,"Town of Beekmantown 4 ",0,2,0,0,2,0.52
DELEGATES TO NATIONAL CONVENTION 21st Congressional District,Scott M. Dolan (M),DM9,"Town of Black Brook 1 ",0,3,0,1,4,1.49
DELEGATES TO NATIONAL CONVENTION 21st Congressional District,Scott M. Dolan (M),DM9,"Town of Black Brook 2 ",0,1,0,0,1,1.04
DELEGATES TO NATIONAL CONVENTION 21st Congressional District,Scott M. Dolan (M),DM9,"Town of Champlain 1 ",0,3,0,1,4,1.04
DELEGATES TO NATIONAL CONVENTION 21st Congressional District,Scott M. Dolan (M),DM9,"Town of Champlain 2 ",0,2,0,1,3,0.57
DELEGATES TO NATIONAL CONVENTION 21st Congressional District,Scott M. Dolan (M),DM9,"Town of Champlain 3 ",0,4,0,2,6,1.35
DELEGATES TO NATIONAL CONVENTION 21st Congressional District,Scott M. Dolan (M),DM9,"Town of Chazy 1 ",0,4,0,2,6,1.18
DELEGATES TO NATIONAL CONVENTION 21st Congressional District,Scott M. Dolan (M),DM9,"Town of Chazy 2 ",0,3,0,1,4,0.91
DELEGATES TO NATIONAL CONVENTION 21st Congressional District,Scott M. Dolan (M),DM9,"Town of Clinton 1 ",0,0,0,0,0,0.00
DELEGATES TO NATIONAL CONVENTION 21st Congressional District,Scott M. Dolan (M),DM9,"Town of Dannemora 1 ",0,0,0,0,0,0.00
DELEGATES TO NATIONAL CONVENTION 21st Congressional District,Scott M. Dolan (M),DM9,"Town of Dannemora 2 ",0,0,0,0,0,0.00
DELEGATES TO NATIONAL CONVENTION 21st Congressional District,Scott M. Dolan (M),DM9,"Town of Dannemora 3 ",0,1,0,2,3,1.63
DELEGATES TO NATIONAL CONVENTION 21st Congressional District,Scott M. Dolan (M),DM9,"Town of Ellenburg 1 ",0,1,0,0,1,0.28
DELEGATES TO NATIONAL CONVENTION 21st Congressional District,Scott M. Dolan (M),DM9,"Town of Mooers 1 ",0,3,0,5,8,2.39
DELEGATES TO NATIONAL CONVENTION 21st Congressional District,Scott M. Dolan (M),DM9,"Town of Mooers 2 ",0,0,0,0,0,0.00
DELEGATES TO NATIONAL CONVENTION 21st Congressional District,Scott M. Dolan (M),DM9,"Town of Peru 1 ",0,0,0,2,2,0.54
DELEGATES TO NATIONAL CONVENTION 21st Congressional District,Scott M. Dolan (M),DM9,"Town of Peru 2 ",0,2,0,1,3,0.55
DELEGATES TO NATIONAL CONVENTION 21st Congressional District,Scott M. Dolan (M),DM9,"Town of Peru 3 ",0,2,0,0,2,1.01
DELEGATES TO NATIONAL CONVENTION 21st Congressional District,Scott M. Dolan (M),DM9,"Town of Peru 4 ",0,4,0,2,6,1.12
DELEGATES TO NATIONAL CONVENTION 21st Congressional District,Scott M. Dolan (M),DM9,"Town of Plattsburgh 1 ",0,4,0,1,5,1.34
DELEGATES TO NATIONAL CONVENTION 21st Congressional District,Scott M. Dolan (M),DM9,"Town of Plattsburgh 2 ",0,2,0,1,3,0.62
DELEGATES TO NATIONAL CONVENTION 21st Congressional District,Scott M. Dolan (M),DM9,"Town of Plattsburgh 3 ",0,3,0,3,6,0.91
DELEGATES TO NATIONAL CONVENTION 21st Congressional District,Scott M. Dolan (M),DM9,"Town of Plattsburgh 4 ",0,1,0,2,3,0.74
DELEGATES TO NATIONAL CONVENTION 21st Congressional District,Scott M. Dolan (M),DM9,"Town of Plattsburgh 5 ",0,1,0,1,2,0.66
DELEGATES TO NATIONAL CONVENTION 21st Congressional District,Scott M. Dolan (M),DM9,"Town of Plattsburgh 6 ",0,5,0,5,10,1.11
DELEGATES TO NATIONAL CONVENTION 21st Congressional District,Scott M. Dolan (M),DM9,"Town of Plattsburgh 7 ",0,1,0,1,2,0.58
DELEGATES TO NATIONAL CONVENTION 21st Congressional District,Scott M. Dolan (M),DM9,"Town of Saranac 1 ",0,3,0,0,3,0.68
DELEGATES TO NATIONAL CONVENTION 21st Congressional District,Scott M. Dolan (M),DM9,"Town of Saranac 2 ",0,1,0,1,2,0.81
DELEGATES TO NATIONAL CONVENTION 21st Congressional District,Scott M. Dolan (M),DM9,"Town of Saranac 3 ",0,1,0,0,1,0.48
DELEGATES TO NATIONAL CONVENTION 21st Congressional District,Scott M. Dolan (M),DM9,"Town of Schuyler Falls 1 ",0,0,0,1,1,0.63
DELEGATES TO NATIONAL CONVENTION 21st Congressional District,Scott M. Dolan (M),DM9,"Town of Schuyler Falls 2 ",0,3,0,1,4,0.88
DELEGATES TO NATIONAL CONVENTION 21st Congressional District,Scott M. Dolan (M),DM9,"Town of Schuyler Falls 3 ",0,0,0,1,1,0.27
DELEGATES TO NATIONAL CONVENTION 21st Congressional District,Kelli O'Sullivan (F),DM10,"City of Plattsburgh Ward 1 1 ",0,1,0,1,2,1.12
DELEGATES TO NATIONAL CONVENTION 21st Congressional District,Kelli O'Sullivan (F),DM10,"City of Plattsburgh Ward 1 2 ",0,7,0,5,12,0.97
DELEGATES TO NATIONAL CONVENTION 21st Congressional District,Kelli O'Sullivan (F),DM10,"City of Plattsburgh Ward 1 3 ",0,0,0,0,0,0.00
DELEGATES TO NATIONAL CONVENTION 21st Congressional District,Kelli O'Sullivan (F),DM10,"City of Plattsburgh Ward 2 1 ",0,2,0,2,4,1.03
DELEGATES TO NATIONAL CONVENTION 21st Congressional District,Kelli O'Sullivan (F),DM10,"City of Plattsburgh Ward 2 2 ",0,5,0,3,8,3.27
DELEGATES TO NATIONAL CONVENTION 21st Congressional District,Kelli O'Sullivan (F),DM10,"City of Plattsburgh Ward 3 1 ",0,3,0,1,4,0.73
DELEGATES TO NATIONAL CONVENTION 21st Congressional District,Kelli O'Sullivan (F),DM10,"City of Plattsburgh Ward 3 2 ",0,5,0,4,9,1.06
DELEGATES TO NATIONAL CONVENTION 21st Congressional District,Kelli O'Sullivan (F),DM10,"City of Plattsburgh Ward 4 1 ",0,4,0,9,13,1.61
DELEGATES TO NATIONAL CONVENTION 21st Congressional District,Kelli O'Sullivan (F),DM10,"City of Plattsburgh Ward 4 2 ",0,6,0,7,13,1.63
DELEGATES TO NATIONAL CONVENTION 21st Congressional District,Kelli O'Sullivan (F),DM10,"City of Plattsburgh Ward 5 1 ",0,6,0,4,10,1.80
DELEGATES TO NATIONAL CONVENTION 21st Congressional District,Kelli O'Sullivan (F),DM10,"City of Plattsburgh Ward 5 2 ",0,6,0,6,12,1.49
DELEGATES TO NATIONAL CONVENTION 21st Congressional District,Kelli O'Sullivan (F),DM10,"City of Plattsburgh Ward 6 1 ",0,5,0,7,12,1.78
DELEGATES TO NATIONAL CONVENTION 21st Congressional District,Kelli O'Sullivan (F),DM10,"City of Plattsburgh Ward 6 2 ",0,2,0,1,3,0.91
DELEGATES TO NATIONAL CONVENTION 21st Congressional District,Kelli O'Sullivan (F),DM10,"Town of Altona 1 ",0,4,0,2,6,1.45
DELEGATES TO NATIONAL CONVENTION 21st Congressional District,Kelli O'Sullivan (F),DM10,"Town of AuSable 1 ",0,0,0,1,1,0.40
DELEGATES TO NATIONAL CONVENTION 21st Congressional District,Kelli O'Sullivan (F),DM10,"Town of AuSable 2 ",0,3,0,2,5,1.88
DELEGATES TO NATIONAL CONVENTION 21st Congressional District,Kelli O'Sullivan (F),DM10,"Town of Beekmantown 1 ",0,1,0,2,3,0.83
DELEGATES TO NATIONAL CONVENTION 21st Congressional District,Kelli O'Sullivan (F),DM10,"Town of Beekmantown 2 ",0,2,0,1,3,0.99
DELEGATES TO NATIONAL CONVENTION 21st Congressional District,Kelli O'Sullivan (F),DM10,"Town of Beekmantown 3 ",0,6,0,2,8,1.07
DELEGATES TO NATIONAL CONVENTION 21st Congressional District,Kelli O'Sullivan (F),DM10,"Town of Beekmantown 4 ",0,2,0,2,4,1.04
DELEGATES TO NATIONAL CONVENTION 21st Congressional District,Kelli O'Sullivan (F),DM10,"Town of Black Brook 1 ",0,1,0,1,2,0.74
DELEGATES TO NATIONAL CONVENTION 21st Congressional District,Kelli O'Sullivan (F),DM10,"Town of Black Brook 2 ",0,0,0,1,1,1.04
DELEGATES TO NATIONAL CONVENTION 21st Congressional District,Kelli O'Sullivan (F),DM10,"Town of Champlain 1 ",0,3,0,2,5,1.30
DELEGATES TO NATIONAL CONVENTION 21st Congressional District,Kelli O'Sullivan (F),DM10,"Town of Champlain 2 ",0,2,0,2,4,0.76
DELEGATES TO NATIONAL CONVENTION 21st Congressional District,Kelli O'Sullivan (F),DM10,"Town of Champlain 3 ",0,3,0,4,7,1.57
DELEGATES TO NATIONAL CONVENTION 21st Congressional District,Kelli O'Sullivan (F),DM10,"Town of Chazy 1 ",0,0,0,2,2,0.39
DELEGATES TO NATIONAL CONVENTION 21st Congressional District,Kelli O'Sullivan (F),DM10,"Town of Chazy 2 ",0,8,0,1,9,2.05
DELEGATES TO NATIONAL CONVENTION 21st Congressional District,Kelli O'Sullivan (F),DM10,"Town of Clinton 1 ",0,0,0,0,0,0.00
DELEGATES TO NATIONAL CONVENTION 21st Congressional District,Kelli O'Sullivan (F),DM10,"Town of Dannemora 1 ",0,0,0,3,3,3.75
DELEGATES TO NATIONAL CONVENTION 21st Congressional District,Kelli O'Sullivan (F),DM10,"Town of Dannemora 2 ",0,0,0,1,1,0.79
DELEGATES TO NATIONAL CONVENTION 21st Congressional District,Kelli O'Sullivan (F),DM10,"Town of Dannemora 3 ",0,0,0,4,4,2.17
DELEGATES TO NATIONAL CONVENTION 21st Congressional District,Kelli O'Sullivan (F),DM10,"Town of Ellenburg 1 ",0,5,0,0,5,1.41
DELEGATES TO NATIONAL CONVENTION 21st Congressional District,Kelli O'Sullivan (F),DM10,"Town of Mooers 1 ",0,4,0,4,8,2.39
DELEGATES TO NATIONAL CONVENTION 21st Congressional District,Kelli O'Sullivan (F),DM10,"Town of Mooers 2 ",0,2,0,1,3,2.14
DELEGATES TO NATIONAL CONVENTION 21st Congressional District,Kelli O'Sullivan (F),DM10,"Town of Peru 1 ",0,4,0,3,7,1.88
DELEGATES TO NATIONAL CONVENTION 21st Congressional District,Kelli O'Sullivan (F),DM10,"Town of Peru 2 ",0,6,0,2,8,1.47
DELEGATES TO NATIONAL CONVENTION 21st Congressional District,Kelli O'Sullivan (F),DM10,"Town of Peru 3 ",0,2,0,0,2,1.01
DELEGATES TO NATIONAL CONVENTION 21st Congressional District,Kelli O'Sullivan (F),DM10,"Town of Peru 4 ",0,7,0,1,8,1.49
DELEGATES TO NATIONAL CONVENTION 21st Congressional District,Kelli O'Sullivan (F),DM10,"Town of Plattsburgh 1 ",0,3,0,2,5,1.34
DELEGATES TO NATIONAL CONVENTION 21st Congressional District,Kelli O'Sullivan (F),DM10,"Town of Plattsburgh 2 ",0,1,0,0,1,0.21
DELEGATES TO NATIONAL CONVENTION 21st Congressional District,Kelli O'Sullivan (F),DM10,"Town of Plattsburgh 3 ",0,7,0,3,10,1.52
DELEGATES TO NATIONAL CONVENTION 21st Congressional District,Kelli O'Sullivan (F),DM10,"Town of Plattsburgh 4 ",0,2,0,2,4,0.99
DELEGATES TO NATIONAL CONVENTION 21st Congressional District,Kelli O'Sullivan (F),DM10,"Town of Plattsburgh 5 ",0,1,0,3,4,1.31
DELEGATES TO NATIONAL CONVENTION 21st Congressional District,Kelli O'Sullivan (F),DM10,"Town of Plattsburgh 6 ",0,5,0,7,12,1.33
DELEGATES TO NATIONAL CONVENTION 21st Congressional District,Kelli O'Sullivan (F),DM10,"Town of Plattsburgh 7 ",0,4,0,0,4,1.15
DELEGATES TO NATIONAL CONVENTION 21st Congressional District,Kelli O'Sullivan (F),DM10,"Town of Saranac 1 ",0,4,0,3,7,1.60
DELEGATES TO NATIONAL CONVENTION 21st Congressional District,Kelli O'Sullivan (F),DM10,"Town of Saranac 2 ",0,1,0,2,3,1.22
DELEGATES TO NATIONAL CONVENTION 21st Congressional District,Kelli O'Sullivan (F),DM10,"Town of Saranac 3 ",0,1,0,2,3,1.44
DELEGATES TO NATIONAL CONVENTION 21st Congressional District,Kelli O'Sullivan (F),DM10,"Town of Schuyler Falls 1 ",0,1,0,2,3,1.89
DELEGATES TO NATIONAL CONVENTION 21st Congressional District,Kelli O'Sullivan (F),DM10,"Town of Schuyler Falls 2 ",0,7,0,2,9,1.99
DELEGATES TO NATIONAL CONVENTION 21st Congressional District,Kelli O'Sullivan (F),DM10,"Town of Schuyler Falls 3 ",0,2,0,2,4,1.08
DELEGATES TO NATIONAL CONVENTION 21st Congressional District,Mark Lienau (M),DM10,"City of Plattsburgh Ward 1 1 ",0,4,0,0,4,2.25
DELEGATES TO NATIONAL CONVENTION 21st Congressional District,Mark Lienau (M),DM10,"City of Plattsburgh Ward 1 2 ",0,3,0,1,4,0.32
DELEGATES TO NATIONAL CONVENTION 21st Congressional District,Mark Lienau (M),DM10,"City of Plattsburgh Ward 1 3 ",0,0,0,0,0,0.00
DELEGATES TO NATIONAL CONVENTION 21st Congressional District,Mark Lienau (M),DM10,"City of Plattsburgh Ward 2 1 ",0,1,0,1,2,0.51
DELEGATES TO NATIONAL CONVENTION 21st Congressional District,Mark Lienau (M),DM10,"City of Plattsburgh Ward 2 2 ",0,4,0,2,6,2.45
DELEGATES TO NATIONAL CONVENTION 21st Congressional District,Mark Lienau (M),DM10,"City of Plattsburgh Ward 3 1 ",0,1,0,0,1,0.18
DELEGATES TO NATIONAL CONVENTION 21st Congressional District,Mark Lienau (M),DM10,"City of Plattsburgh Ward 3 2 ",0,0,0,2,2,0.24
DELEGATES TO NATIONAL CONVENTION 21st Congressional District,Mark Lienau (M),DM10,"City of Plattsburgh Ward 4 1 ",0,2,0,3,5,0.62
DELEGATES TO NATIONAL CONVENTION 21st Congressional District,Mark Lienau (M),DM10,"City of Plattsburgh Ward 4 2 ",0,0,0,1,1,0.13
DELEGATES TO NATIONAL CONVENTION 21st Congressional District,Mark Lienau (M),DM10,"City of Plattsburgh Ward 5 1 ",0,0,0,0,0,0.00
DELEGATES TO NATIONAL CONVENTION 21st Congressional District,Mark Lienau (M),DM10,"City of Plattsburgh Ward 5 2 ",0,2,0,1,3,0.37
DELEGATES TO NATIONAL CONVENTION 21st Congressional District,Mark Lienau (M),DM10,"City of Plattsburgh Ward 6 1 ",0,2,0,2,4,0.59
DELEGATES TO NATIONAL CONVENTION 21st Congressional District,Mark Lienau (M),DM10,"City of Plattsburgh Ward 6 2 ",0,0,0,2,2,0.61
DELEGATES TO NATIONAL CONVENTION 21st Congressional District,Mark Lienau (M),DM10,"Town of Altona 1 ",0,1,0,0,1,0.24
DELEGATES TO NATIONAL CONVENTION 21st Congressional District,Mark Lienau (M),DM10,"Town of AuSable 1 ",0,1,0,1,2,0.80
DELEGATES TO NATIONAL CONVENTION 21st Congressional District,Mark Lienau (M),DM10,"Town of AuSable 2 ",0,1,0,0,1,0.38
DELEGATES TO NATIONAL CONVENTION 21st Congressional District,Mark Lienau (M),DM10,"Town of Beekmantown 1 ",0,2,0,0,2,0.55
DELEGATES TO NATIONAL CONVENTION 21st Congressional District,Mark Lienau (M),DM10,"Town of Beekmantown 2 ",0,1,0,1,2,0.66
DELEGATES TO NATIONAL CONVENTION 21st Congressional District,Mark Lienau (M),DM10,"Town of Beekmantown 3 ",0,0,0,0,0,0.00
DELEGATES TO NATIONAL CONVENTION 21st Congressional District,Mark Lienau (M),DM10,"Town of Beekmantown 4 ",0,1,0,1,2,0.52
DELEGATES TO NATIONAL CONVENTION 21st Congressional District,Mark Lienau (M),DM10,"Town of Black Brook 1 ",0,2,0,1,3,1.12
DELEGATES TO NATIONAL CONVENTION 21st Congressional District,Mark Lienau (M),DM10,"Town of Black Brook 2 ",0,0,0,0,0,0.00
DELEGATES TO NATIONAL CONVENTION 21st Congressional District,Mark Lienau (M),DM10,"Town of Champlain 1 ",0,2,0,1,3,0.78
DELEGATES TO NATIONAL CONVENTION 21st Congressional District,Mark Lienau (M),DM10,"Town of Champlain 2 ",0,0,0,1,1,0.19
DELEGATES TO NATIONAL CONVENTION 21st Congressional District,Mark Lienau (M),DM10,"Town of Champlain 3 ",0,0,0,1,1,0.22
DELEGATES TO NATIONAL CONVENTION 21st Congressional District,Mark Lienau (M),DM10,"Town of Chazy 1 ",0,0,0,2,2,0.39
DELEGATES TO NATIONAL CONVENTION 21st Congressional District,Mark Lienau (M),DM10,"Town of Chazy 2 ",0,1,0,1,2,0.45
DELEGATES TO NATIONAL CONVENTION 21st Congressional District,Mark Lienau (M),DM10,"Town of Clinton 1 ",0,0,0,0,0,0.00
DELEGATES TO NATIONAL CONVENTION 21st Congressional District,Mark Lienau (M),DM10,"Town of Dannemora 1 ",0,0,0,3,3,3.75
DELEGATES TO NATIONAL CONVENTION 21st Congressional District,Mark Lienau (M),DM10,"Town of Dannemora 2 ",0,0,0,0,0,0.00
DELEGATES TO NATIONAL CONVENTION 21st Congressional District,Mark Lienau (M),DM10,"Town of Dannemora 3 ",0,1,0,0,1,0.54
DELEGATES TO NATIONAL CONVENTION 21st Congressional District,Mark Lienau (M),DM10,"Town of Ellenburg 1 ",0,0,0,0,0,0.00
DELEGATES TO NATIONAL CONVENTION 21st Congressional District,Mark Lienau (M),DM10,"Town of Mooers 1 ",0,0,0,0,0,0.00
DELEGATES TO NATIONAL CONVENTION 21st Congressional District,Mark Lienau (M),DM10,"Town of Mooers 2 ",0,0,0,0,0,0.00
DELEGATES TO NATIONAL CONVENTION 21st Congressional District,Mark Lienau (M),DM10,"Town of Peru 1 ",0,1,0,2,3,0.80
DELEGATES TO NATIONAL CONVENTION 21st Congressional District,Mark Lienau (M),DM10,"Town of Peru 2 ",0,3,0,2,5,0.92
DELEGATES TO NATIONAL CONVENTION 21st Congressional District,Mark Lienau (M),DM10,"Town of Peru 3 ",0,0,0,0,0,0.00
DELEGATES TO NATIONAL CONVENTION 21st Congressional District,Mark Lienau (M),DM10,"Town of Peru 4 ",0,3,0,0,3,0.56
DELEGATES TO NATIONAL CONVENTION 21st Congressional District,Mark Lienau (M),DM10,"Town of Plattsburgh 1 ",0,0,0,0,0,0.00
DELEGATES TO NATIONAL CONVENTION 21st Congressional District,Mark Lienau (M),DM10,"Town of Plattsburgh 2 ",0,1,0,1,2,0.42
DELEGATES TO NATIONAL CONVENTION 21st Congressional District,Mark Lienau (M),DM10,"Town of Plattsburgh 3 ",0,3,0,1,4,0.61
DELEGATES TO NATIONAL CONVENTION 21st Congressional District,Mark Lienau (M),DM10,"Town of Plattsburgh 4 ",0,0,0,1,1,0.25
DELEGATES TO NATIONAL CONVENTION 21st Congressional District,Mark Lienau (M),DM10,"Town of Plattsburgh 5 ",0,0,0,1,1,0.33
DELEGATES TO NATIONAL CONVENTION 21st Congressional District,Mark Lienau (M),DM10,"Town of Plattsburgh 6 ",0,1,0,0,1,0.11
DELEGATES TO NATIONAL CONVENTION 21st Congressional District,Mark Lienau (M),DM10,"Town of Plattsburgh 7 ",0,1,0,0,1,0.29
DELEGATES TO NATIONAL CONVENTION 21st Congressional District,Mark Lienau (M),DM10,"Town of Saranac 1 ",0,0,0,2,2,0.46
DELEGATES TO NATIONAL CONVENTION 21st Congressional District,Mark Lienau (M),DM10,"Town of Saranac 2 ",0,0,0,0,0,0.00
DELEGATES TO NATIONAL CONVENTION 21st Congressional District,Mark Lienau (M),DM10,"Town of Saranac 3 ",0,0,0,1,1,0.48
DELEGATES TO NATIONAL CONVENTION 21st Congressional District,Mark Lienau (M),DM10,"Town of Schuyler Falls 1 ",0,0,0,0,0,0.00
DELEGATES TO NATIONAL CONVENTION 21st Congressional District,Mark Lienau (M),DM10,"Town of Schuyler Falls 2 ",0,1,0,0,1,0.22
DELEGATES TO NATIONAL CONVENTION 21st Congressional District,Mark Lienau (M),DM10,"Town of Schuyler Falls 3 ",0,3,0,0,3,0.81
DELEGATES TO NATIONAL CONVENTION 21st Congressional District,Stephanie Bodensieck (F),DM10,"City of Plattsburgh Ward 1 1 ",0,1,0,0,1,0.56
DELEGATES TO NATIONAL CONVENTION 21st Congressional District,Stephanie Bodensieck (F),DM10,"City of Plattsburgh Ward 1 2 ",0,7,0,1,8,0.65
DELEGATES TO NATIONAL CONVENTION 21st Congressional District,Stephanie Bodensieck (F),DM10,"City of Plattsburgh Ward 1 3 ",0,0,0,0,0,0.00
DELEGATES TO NATIONAL CONVENTION 21st Congressional District,Stephanie Bodensieck (F),DM10,"City of Plattsburgh Ward 2 1 ",0,1,0,1,2,0.51
DELEGATES TO NATIONAL CONVENTION 21st Congressional District,Stephanie Bodensieck (F),DM10,"City of Plattsburgh Ward 2 2 ",0,3,0,3,6,2.45
DELEGATES TO NATIONAL CONVENTION 21st Congressional District,Stephanie Bodensieck (F),DM10,"City of Plattsburgh Ward 3 1 ",0,5,0,3,8,1.46
DELEGATES TO NATIONAL CONVENTION 21st Congressional District,Stephanie Bodensieck (F),DM10,"City of Plattsburgh Ward 3 2 ",0,5,0,2,7,0.83
DELEGATES TO NATIONAL CONVENTION 21st Congressional District,Stephanie Bodensieck (F),DM10,"City of Plattsburgh Ward 4 1 ",0,4,0,6,10,1.24
DELEGATES TO NATIONAL CONVENTION 21st Congressional District,Stephanie Bodensieck (F),DM10,"City of Plattsburgh Ward 4 2 ",0,6,0,3,9,1.13
DELEGATES TO NATIONAL CONVENTION 21st Congressional District,Stephanie Bodensieck (F),DM10,"City of Plattsburgh Ward 5 1 ",0,2,0,2,4,0.72
DELEGATES TO NATIONAL CONVENTION 21st Congressional District,Stephanie Bodensieck (F),DM10,"City of Plattsburgh Ward 5 2 ",0,6,0,2,8,1.00
DELEGATES TO NATIONAL CONVENTION 21st Congressional District,Stephanie Bodensieck (F),DM10,"City of Plattsburgh Ward 6 1 ",0,1,0,4,5,0.74
DELEGATES TO NATIONAL CONVENTION 21st Congressional District,Stephanie Bodensieck (F),DM10,"City of Plattsburgh Ward 6 2 ",0,1,0,1,2,0.61
DELEGATES TO NATIONAL CONVENTION 21st Congressional District,Stephanie Bodensieck (F),DM10,"Town of Altona 1 ",0,4,0,0,4,0.96
DELEGATES TO NATIONAL CONVENTION 21st Congressional District,Stephanie Bodensieck (F),DM10,"Town of AuSable 1 ",0,1,0,3,4,1.61
DELEGATES TO NATIONAL CONVENTION 21st Congressional District,Stephanie Bodensieck (F),DM10,"Town of AuSable 2 ",0,1,0,0,1,0.38
DELEGATES TO NATIONAL CONVENTION 21st Congressional District,Stephanie Bodensieck (F),DM10,"Town of Beekmantown 1 ",0,0,0,2,2,0.55
DELEGATES TO NATIONAL CONVENTION 21st Congressional District,Stephanie Bodensieck (F),DM10,"Town of Beekmantown 2 ",0,1,0,1,2,0.66
DELEGATES TO NATIONAL CONVENTION 21st Congressional District,Stephanie Bodensieck (F),DM10,"Town of Beekmantown 3 ",0,0,0,1,1,0.13
DELEGATES TO NATIONAL CONVENTION 21st Congressional District,Stephanie Bodensieck (F),DM10,"Town of Beekmantown 4 ",0,1,0,0,1,0.26
DELEGATES TO NATIONAL CONVENTION 21st Congressional District,Stephanie Bodensieck (F),DM10,"Town of Black Brook 1 ",0,0,0,0,0,0.00
DELEGATES TO NATIONAL CONVENTION 21st Congressional District,Stephanie Bodensieck (F),DM10,"Town of Black Brook 2 ",0,0,0,1,1,1.04
DELEGATES TO NATIONAL CONVENTION 21st Congressional District,Stephanie Bodensieck (F),DM10,"Town of Champlain 1 ",0,6,0,1,7,1.81
DELEGATES TO NATIONAL CONVENTION 21st Congressional District,Stephanie Bodensieck (F),DM10,"Town of Champlain 2 ",0,2,0,5,7,1.32
DELEGATES TO NATIONAL CONVENTION 21st Congressional District,Stephanie Bodensieck (F),DM10,"Town of Champlain 3 ",0,0,0,0,0,0.00
DELEGATES TO NATIONAL CONVENTION 21st Congressional District,Stephanie Bodensieck (F),DM10,"Town of Chazy 1 ",0,1,0,0,1,0.20
DELEGATES TO NATIONAL CONVENTION 21st Congressional District,Stephanie Bodensieck (F),DM10,"Town of Chazy 2 ",0,3,0,2,5,1.14
DELEGATES TO NATIONAL CONVENTION 21st Congressional District,Stephanie Bodensieck (F),DM10,"Town of Clinton 1 ",0,0,0,1,1,0.95
DELEGATES TO NATIONAL CONVENTION 21st Congressional District,Stephanie Bodensieck (F),DM10,"Town of Dannemora 1 ",0,1,0,4,5,6.25
DELEGATES TO NATIONAL CONVENTION 21st Congressional District,Stephanie Bodensieck (F),DM10,"Town of Dannemora 2 ",0,1,0,1,2,1.59
DELEGATES TO NATIONAL CONVENTION 21st Congressional District,Stephanie Bodensieck (F),DM10,"Town of Dannemora 3 ",0,1,0,1,2,1.09
DELEGATES TO NATIONAL CONVENTION 21st Congressional District,Stephanie Bodensieck (F),DM10,"Town of Ellenburg 1 ",0,1,0,1,2,0.56
DELEGATES TO NATIONAL CONVENTION 21st Congressional District,Stephanie Bodensieck (F),DM10,"Town of Mooers 1 ",0,4,0,2,6,1.79
DELEGATES TO NATIONAL CONVENTION 21st Congressional District,Stephanie Bodensieck (F),DM10,"Town of Mooers 2 ",0,0,0,0,0,0.00
DELEGATES TO NATIONAL CONVENTION 21st Congressional District,Stephanie Bodensieck (F),DM10,"Town of Peru 1 ",0,1,0,0,1,0.27
DELEGATES TO NATIONAL CONVENTION 21st Congressional District,Stephanie Bodensieck (F),DM10,"Town of Peru 2 ",0,3,0,2,5,0.92
DELEGATES TO NATIONAL CONVENTION 21st Congressional District,Stephanie Bodensieck (F),DM10,"Town of Peru 3 ",0,1,0,0,1,0.50
DELEGATES TO NATIONAL CONVENTION 21st Congressional District,Stephanie Bodensieck (F),DM10,"Town of Peru 4 ",0,6,0,2,8,1.49
DELEGATES TO NATIONAL CONVENTION 21st Congressional District,Stephanie Bodensieck (F),DM10,"Town of Plattsburgh 1 ",0,1,0,1,2,0.54
DELEGATES TO NATIONAL CONVENTION 21st Congressional District,Stephanie Bodensieck (F),DM10,"Town of Plattsburgh 2 ",0,2,0,0,2,0.42
DELEGATES TO NATIONAL CONVENTION 21st Congressional District,Stephanie Bodensieck (F),DM10,"Town of Plattsburgh 3 ",0,2,0,0,2,0.30
DELEGATES TO NATIONAL CONVENTION 21st Congressional District,Stephanie Bodensieck (F),DM10,"Town of Plattsburgh 4 ",0,1,0,2,3,0.74
DELEGATES TO NATIONAL CONVENTION 21st Congressional District,Stephanie Bodensieck (F),DM10,"Town of Plattsburgh 5 ",0,1,0,1,2,0.66
DELEGATES TO NATIONAL CONVENTION 21st Congressional District,Stephanie Bodensieck (F),DM10,"Town of Plattsburgh 6 ",0,7,0,5,12,1.33
DELEGATES TO NATIONAL CONVENTION 21st Congressional District,Stephanie Bodensieck (F),DM10,"Town of Plattsburgh 7 ",0,2,0,0,2,0.58
DELEGATES TO NATIONAL CONVENTION 21st Congressional District,Stephanie Bodensieck (F),DM10,"Town of Saranac 1 ",0,4,0,3,7,1.60
DELEGATES TO NATIONAL CONVENTION 21st Congressional District,Stephanie Bodensieck (F),DM10,"Town of Saranac 2 ",0,0,0,0,0,0.00
DELEGATES TO NATIONAL CONVENTION 21st Congressional District,Stephanie Bodensieck (F),DM10,"Town of Saranac 3 ",0,3,0,0,3,1.44
DELEGATES TO NATIONAL CONVENTION 21st Congressional District,Stephanie Bodensieck (F),DM10,"Town of Schuyler Falls 1 ",0,2,0,1,3,1.89
DELEGATES TO NATIONAL CONVENTION 21st Congressional District,Stephanie Bodensieck (F),DM10,"Town of Schuyler Falls 2 ",0,3,0,1,4,0.88
DELEGATES TO NATIONAL CONVENTION 21st Congressional District,Stephanie Bodensieck (F),DM10,"Town of Schuyler Falls 3 ",0,1,0,3,4,1.08
DELEGATES TO NATIONAL CONVENTION 21st Congressional District,Kevin M. Laake (M),DM10,"City of Plattsburgh Ward 1 1 ",0,1,0,0,1,0.56
DELEGATES TO NATIONAL CONVENTION 21st Congressional District,Kevin M. Laake (M),DM10,"City of Plattsburgh Ward 1 2 ",0,3,0,3,6,0.48
DELEGATES TO NATIONAL CONVENTION 21st Congressional District,Kevin M. Laake (M),DM10,"City of Plattsburgh Ward 1 3 ",0,0,0,0,0,0.00
DELEGATES TO NATIONAL CONVENTION 21st Congressional District,Kevin M. Laake (M),DM10,"City of Plattsburgh Ward 2 1 ",0,1,0,0,1,0.26
DELEGATES TO NATIONAL CONVENTION 21st Congressional District,Kevin M. Laake (M),DM10,"City of Plattsburgh Ward 2 2 ",0,3,0,2,5,2.04
DELEGATES TO NATIONAL CONVENTION 21st Congressional District,Kevin M. Laake (M),DM10,"City of Plattsburgh Ward 3 1 ",0,2,0,1,3,0.55
DELEGATES TO NATIONAL CONVENTION 21st Congressional District,Kevin M. Laake (M),DM10,"City of Plattsburgh Ward 3 2 ",0,1,0,2,3,0.35
DELEGATES TO NATIONAL CONVENTION 21st Congressional District,Kevin M. Laake (M),DM10,"City of Plattsburgh Ward 4 1 ",0,1,0,3,4,0.50
DELEGATES TO NATIONAL CONVENTION 21st Congressional District,Kevin M. Laake (M),DM10,"City of Plattsburgh Ward 4 2 ",0,2,0,1,3,0.38
DELEGATES TO NATIONAL CONVENTION 21st Congressional District,Kevin M. Laake (M),DM10,"City of Plattsburgh Ward 5 1 ",0,1,0,1,2,0.36
DELEGATES TO NATIONAL CONVENTION 21st Congressional District,Kevin M. Laake (M),DM10,"City of Plattsburgh Ward 5 2 ",0,2,0,1,3,0.37
DELEGATES TO NATIONAL CONVENTION 21st Congressional District,Kevin M. Laake (M),DM10,"City of Plattsburgh Ward 6 1 ",0,2,0,5,7,1.04
DELEGATES TO NATIONAL CONVENTION 21st Congressional District,Kevin M. Laake (M),DM10,"City of Plattsburgh Ward 6 2 ",0,0,0,2,2,0.61
DELEGATES TO NATIONAL CONVENTION 21st Congressional District,Kevin M. Laake (M),DM10,"Town of Altona 1 ",0,3,0,0,3,0.72
DELEGATES TO NATIONAL CONVENTION 21st Congressional District,Kevin M. Laake (M),DM10,"Town of AuSable 1 ",0,1,0,0,1,0.40
DELEGATES TO NATIONAL CONVENTION 21st Congressional District,Kevin M. Laake (M),DM10,"Town of AuSable 2 ",0,0,0,0,0,0.00
DELEGATES TO NATIONAL CONVENTION 21st Congressional District,Kevin M. Laake (M),DM10,"Town of Beekmantown 1 ",0,0,0,0,0,0.00
DELEGATES TO NATIONAL CONVENTION 21st Congressional District,Kevin M. Laake (M),DM10,"Town of Beekmantown 2 ",0,1,0,1,2,0.66
DELEGATES TO NATIONAL CONVENTION 21st Congressional District,Kevin M. Laake (M),DM10,"Town of Beekmantown 3 ",0,2,0,1,3,0.40
DELEGATES TO NATIONAL CONVENTION 21st Congressional District,Kevin M. Laake (M),DM10,"Town of Beekmantown 4 ",0,0,0,1,1,0.26
DELEGATES TO NATIONAL CONVENTION 21st Congressional District,Kevin M. Laake (M),DM10,"Town of Black Brook 1 ",0,0,0,0,0,0.00
DELEGATES TO NATIONAL CONVENTION 21st Congressional District,Kevin M. Laake (M),DM10,"Town of Black Brook 2 ",0,0,0,0,0,0.00
DELEGATES TO NATIONAL CONVENTION 21st Congressional District,Kevin M. Laake (M),DM10,"Town of Champlain 1 ",0,2,0,0,2,0.52
DELEGATES TO NATIONAL CONVENTION 21st Congressional District,Kevin M. Laake (M),DM10,"Town of Champlain 2 ",0,0,0,0,0,0.00
DELEGATES TO NATIONAL CONVENTION 21st Congressional District,Kevin M. Laake (M),DM10,"Town of Champlain 3 ",0,1,0,3,4,0.90
DELEGATES TO NATIONAL CONVENTION 21st Congressional District,Kevin M. Laake (M),DM10,"Town of Chazy 1 ",0,1,0,1,2,0.39
DELEGATES TO NATIONAL CONVENTION 21st Congressional District,Kevin M. Laake (M),DM10,"Town of Chazy 2 ",0,2,0,1,3,0.68
DELEGATES TO NATIONAL CONVENTION 21st Congressional District,Kevin M. Laake (M),DM10,"Town of Clinton 1 ",0,0,0,1,1,0.95
DELEGATES TO NATIONAL CONVENTION 21st Congressional District,Kevin M. Laake (M),DM10,"Town of Dannemora 1 ",0,0,0,3,3,3.75
DELEGATES TO NATIONAL CONVENTION 21st Congressional District,Kevin M. Laake (M),DM10,"Town of Dannemora 2 ",0,0,0,0,0,0.00
DELEGATES TO NATIONAL CONVENTION 21st Congressional District,Kevin M. Laake (M),DM10,"Town of Dannemora 3 ",0,0,0,2,2,1.09
DELEGATES TO NATIONAL CONVENTION 21st Congressional District,Kevin M. Laake (M),DM10,"Town of Ellenburg 1 ",0,3,0,0,3,0.85
DELEGATES TO NATIONAL CONVENTION 21st Congressional District,Kevin M. Laake (M),DM10,"Town of Mooers 1 ",0,1,0,1,2,0.60
DELEGATES TO NATIONAL CONVENTION 21st Congressional District,Kevin M. Laake (M),DM10,"Town of Mooers 2 ",0,2,0,0,2,1.43
DELEGATES TO NATIONAL CONVENTION 21st Congressional District,Kevin M. Laake (M),DM10,"Town of Peru 1 ",0,2,0,2,4,1.07
DELEGATES TO NATIONAL CONVENTION 21st Congressional District,Kevin M. Laake (M),DM10,"Town of Peru 2 ",0,4,0,2,6,1.10
DELEGATES TO NATIONAL CONVENTION 21st Congressional District,Kevin M. Laake (M),DM10,"Town of Peru 3 ",0,0,0,1,1,0.50
DELEGATES TO NATIONAL CONVENTION 21st Congressional District,Kevin M. Laake (M),DM10,"Town of Peru 4 ",0,2,0,1,3,0.56
DELEGATES TO NATIONAL CONVENTION 21st Congressional District,Kevin M. Laake (M),DM10,"Town of Plattsburgh 1 ",0,5,0,0,5,1.34
DELEGATES TO NATIONAL CONVENTION 21st Congressional District,Kevin M. Laake (M),DM10,"Town of Plattsburgh 2 ",0,2,0,0,2,0.42
DELEGATES TO NATIONAL CONVENTION 21st Congressional District,Kevin M. Laake (M),DM10,"Town of Plattsburgh 3 ",0,3,0,0,3,0.46
DELEGATES TO NATIONAL CONVENTION 21st Congressional District,Kevin M. Laake (M),DM10,"Town of Plattsburgh 4 ",0,1,0,2,3,0.74
DELEGATES TO NATIONAL CONVENTION 21st Congressional District,Kevin M. Laake (M),DM10,"Town of Plattsburgh 5 ",0,0,0,0,0,0.00
DELEGATES TO NATIONAL CONVENTION 21st Congressional District,Kevin M. Laake (M),DM10,"Town of Plattsburgh 6 ",0,3,0,0,3,0.33
DELEGATES TO NATIONAL CONVENTION 21st Congressional District,Kevin M. Laake (M),DM10,"Town of Plattsburgh 7 ",0,2,0,0,2,0.58
DELEGATES TO NATIONAL CONVENTION 21st Congressional District,Kevin M. Laake (M),DM10,"Town of Saranac 1 ",0,1,0,2,3,0.68
DELEGATES TO NATIONAL CONVENTION 21st Congressional District,Kevin M. Laake (M),DM10,"Town of Saranac 2 ",0,0,0,0,0,0.00
DELEGATES TO NATIONAL CONVENTION 21st Congressional District,Kevin M. Laake (M),DM10,"Town of Saranac 3 ",0,1,0,0,1,0.48
DELEGATES TO NATIONAL CONVENTION 21st Congressional District,Kevin M. Laake (M),DM10,"Town of Schuyler Falls 1 ",0,0,0,1,1,0.63
DELEGATES TO NATIONAL CONVENTION 21st Congressional District,Kevin M. Laake (M),DM10,"Town of Schuyler Falls 2 ",0,2,0,1,3,0.66
DELEGATES TO NATIONAL CONVENTION 21st Congressional District,Kevin M. Laake (M),DM10,"Town of Schuyler Falls 3 ",0,2,0,0,2,0.54
DELEGATES TO NATIONAL CONVENTION 21st Congressional District,Donna Trimm Calk (F),DM10,"City of Plattsburgh Ward 1 1 ",0,0,0,3,3,1.69
DELEGATES TO NATIONAL CONVENTION 21st Congressional District,Donna Trimm Calk (F),DM10,"City of Plattsburgh Ward 1 2 ",0,4,0,1,5,0.40
DELEGATES TO NATIONAL CONVENTION 21st Congressional District,Donna Trimm Calk (F),DM10,"City of Plattsburgh Ward 1 3 ",0,0,0,0,0,0.00
DELEGATES TO NATIONAL CONVENTION 21st Congressional District,Donna Trimm Calk (F),DM10,"City of Plattsburgh Ward 2 1 ",0,2,0,2,4,1.03
DELEGATES TO NATIONAL CONVENTION 21st Congressional District,Donna Trimm Calk (F),DM10,"City of Plattsburgh Ward 2 2 ",0,4,0,3,7,2.86
DELEGATES TO NATIONAL CONVENTION 21st Congressional District,Donna Trimm Calk (F),DM10,"City of Plattsburgh Ward 3 1 ",0,3,0,4,7,1.28
DELEGATES TO NATIONAL CONVENTION 21st Congressional District,Donna Trimm Calk (F),DM10,"City of Plattsburgh Ward 3 2 ",0,5,0,1,6,0.71
DELEGATES TO NATIONAL CONVENTION 21st Congressional District,Donna Trimm Calk (F),DM10,"City of Plattsburgh Ward 4 1 ",0,4,0,2,6,0.74
DELEGATES TO NATIONAL CONVENTION 21st Congressional District,Donna Trimm Calk (F),DM10,"City of Plattsburgh Ward 4 2 ",0,4,0,3,7,0.88
DELEGATES TO NATIONAL CONVENTION 21st Congressional District,Donna Trimm Calk (F),DM10,"City of Plattsburgh Ward 5 1 ",0,2,0,3,5,0.90
DELEGATES TO NATIONAL CONVENTION 21st Congressional District,Donna Trimm Calk (F),DM10,"City of Plattsburgh Ward 5 2 ",0,5,0,3,8,1.00
DELEGATES TO NATIONAL CONVENTION 21st Congressional District,Donna Trimm Calk (F),DM10,"City of Plattsburgh Ward 6 1 ",0,3,0,3,6,0.89
DELEGATES TO NATIONAL CONVENTION 21st Congressional District,Donna Trimm Calk (F),DM10,"City of Plattsburgh Ward 6 2 ",0,0,0,1,1,0.30
DELEGATES TO NATIONAL CONVENTION 21st Congressional District,Donna Trimm Calk (F),DM10,"Town of Altona 1 ",0,4,0,1,5,1.20
DELEGATES TO NATIONAL CONVENTION 21st Congressional District,Donna Trimm Calk (F),DM10,"Town of AuSable 1 ",0,2,0,2,4,1.61
DELEGATES TO NATIONAL CONVENTION 21st Congressional District,Donna Trimm Calk (F),DM10,"Town of AuSable 2 ",0,0,0,1,1,0.38
DELEGATES TO NATIONAL CONVENTION 21st Congressional District,Donna Trimm Calk (F),DM10,"Town of Beekmantown 1 ",0,1,0,0,1,0.28
DELEGATES TO NATIONAL CONVENTION 21st Congressional District,Donna Trimm Calk (F),DM10,"Town of Beekmantown 2 ",0,0,0,2,2,0.66
DELEGATES TO NATIONAL CONVENTION 21st Congressional District,Donna Trimm Calk (F),DM10,"Town of Beekmantown 3 ",0,3,0,0,3,0.40
DELEGATES TO NATIONAL CONVENTION 21st Congressional District,Donna Trimm Calk (F),DM10,"Town of Beekmantown 4 ",0,1,0,0,1,0.26
DELEGATES TO NATIONAL CONVENTION 21st Congressional District,Donna Trimm Calk (F),DM10,"Town of Black Brook 1 ",0,0,0,1,1,0.37
DELEGATES TO NATIONAL CONVENTION 21st Congressional District,Donna Trimm Calk (F),DM10,"Town of Black Brook 2 ",0,0,0,1,1,1.04
DELEGATES TO NATIONAL CONVENTION 21st Congressional District,Donna Trimm Calk (F),DM10,"Town of Champlain 1 ",0,5,0,1,6,1.55
DELEGATES TO NATIONAL CONVENTION 21st Congressional District,Donna Trimm Calk (F),DM10,"Town of Champlain 2 ",0,4,0,1,5,0.95
DELEGATES TO NATIONAL CONVENTION 21st Congressional District,Donna Trimm Calk (F),DM10,"Town of Champlain 3 ",0,0,0,2,2,0.45
DELEGATES TO NATIONAL CONVENTION 21st Congressional District,Donna Trimm Calk (F),DM10,"Town of Chazy 1 ",0,1,0,1,2,0.39
DELEGATES TO NATIONAL CONVENTION 21st Congressional District,Donna Trimm Calk (F),DM10,"Town of Chazy 2 ",0,4,0,1,5,1.14
DELEGATES TO NATIONAL CONVENTION 21st Congressional District,Donna Trimm Calk (F),DM10,"Town of Clinton 1 ",0,1,0,1,2,1.90
DELEGATES TO NATIONAL CONVENTION 21st Congressional District,Donna Trimm Calk (F),DM10,"Town of Dannemora 1 ",0,0,0,4,4,5.00
DELEGATES TO NATIONAL CONVENTION 21st Congressional District,Donna Trimm Calk (F),DM10,"Town of Dannemora 2 ",0,1,0,0,1,0.79
DELEGATES TO NATIONAL CONVENTION 21st Congressional District,Donna Trimm Calk (F),DM10,"Town of Dannemora 3 ",0,0,0,3,3,1.63
DELEGATES TO NATIONAL CONVENTION 21st Congressional District,Donna Trimm Calk (F),DM10,"Town of Ellenburg 1 ",0,5,0,0,5,1.41
DELEGATES TO NATIONAL CONVENTION 21st Congressional District,Donna Trimm Calk (F),DM10,"Town of Mooers 1 ",0,5,0,0,5,1.49
DELEGATES TO NATIONAL CONVENTION 21st Congressional District,Donna Trimm Calk (F),DM10,"Town of Mooers 2 ",0,0,0,1,1,0.71
DELEGATES TO NATIONAL CONVENTION 21st Congressional District,Donna Trimm Calk (F),DM10,"Town of Peru 1 ",0,1,0,2,3,0.80
DELEGATES TO NATIONAL CONVENTION 21st Congressional District,Donna Trimm Calk (F),DM10,"Town of Peru 2 ",0,7,0,0,7,1.28
DELEGATES TO NATIONAL CONVENTION 21st Congressional District,Donna Trimm Calk (F),DM10,"Town of Peru 3 ",0,3,0,0,3,1.51
DELEGATES TO NATIONAL CONVENTION 21st Congressional District,Donna Trimm Calk (F),DM10,"Town of Peru 4 ",0,5,0,0,5,0.93
DELEGATES TO NATIONAL CONVENTION 21st Congressional District,Donna Trimm Calk (F),DM10,"Town of Plattsburgh 1 ",0,1,0,1,2,0.54
DELEGATES TO NATIONAL CONVENTION 21st Congressional District,Donna Trimm Calk (F),DM10,"Town of Plattsburgh 2 ",0,0,0,1,1,0.21
DELEGATES TO NATIONAL CONVENTION 21st Congressional District,Donna Trimm Calk (F),DM10,"Town of Plattsburgh 3 ",0,4,0,4,8,1.22
DELEGATES TO NATIONAL CONVENTION 21st Congressional District,Donna Trimm Calk (F),DM10,"Town of Plattsburgh 4 ",0,1,0,2,3,0.74
DELEGATES TO NATIONAL CONVENTION 21st Congressional District,Donna Trimm Calk (F),DM10,"Town of Plattsburgh 5 ",0,1,0,1,2,0.66
DELEGATES TO NATIONAL CONVENTION 21st Congressional District,Donna Trimm Calk (F),DM10,"Town of Plattsburgh 6 ",0,2,0,4,6,0.67
DELEGATES TO NATIONAL CONVENTION 21st Congressional District,Donna Trimm Calk (F),DM10,"Town of Plattsburgh 7 ",0,1,0,0,1,0.29
DELEGATES TO NATIONAL CONVENTION 21st Congressional District,Donna Trimm Calk (F),DM10,"Town of Saranac 1 ",0,1,0,1,2,0.46
DELEGATES TO NATIONAL CONVENTION 21st Congressional District,Donna Trimm Calk (F),DM10,"Town of Saranac 2 ",0,2,0,1,3,1.22
DELEGATES TO NATIONAL CONVENTION 21st Congressional District,Donna Trimm Calk (F),DM10,"Town of Saranac 3 ",0,0,0,2,2,0.96
DELEGATES TO NATIONAL CONVENTION 21st Congressional District,Donna Trimm Calk (F),DM10,"Town of Schuyler Falls 1 ",0,1,0,0,1,0.63
DELEGATES TO NATIONAL CONVENTION 21st Congressional District,Donna Trimm Calk (F),DM10,"Town of Schuyler Falls 2 ",0,4,0,3,7,1.55
DELEGATES TO NATIONAL CONVENTION 21st Congressional District,Donna Trimm Calk (F),DM10,"Town of Schuyler Falls 3 ",0,5,0,1,6,1.62
DELEGATES TO NATIONAL CONVENTION 21st Congressional District,Orion G. Harrison (M),DM10,"City of Plattsburgh Ward 1 1 ",0,1,0,0,1,0.56
DELEGATES TO NATIONAL CONVENTION 21st Congressional District,Orion G. Harrison (M),DM10,"City of Plattsburgh Ward 1 2 ",0,3,0,3,6,0.48
DELEGATES TO NATIONAL CONVENTION 21st Congressional District,Orion G. Harrison (M),DM10,"City of Plattsburgh Ward 1 3 ",0,0,0,0,0,0.00
DELEGATES TO NATIONAL CONVENTION 21st Congressional District,Orion G. Harrison (M),DM10,"City of Plattsburgh Ward 2 1 ",0,1,0,0,1,0.26
DELEGATES TO NATIONAL CONVENTION 21st Congressional District,Orion G. Harrison (M),DM10,"City of Plattsburgh Ward 2 2 ",0,3,0,2,5,2.04
DELEGATES TO NATIONAL CONVENTION 21st Congressional District,Orion G. Harrison (M),DM10,"City of Plattsburgh Ward 3 1 ",0,0,0,1,1,0.18
DELEGATES TO NATIONAL CONVENTION 21st Congressional District,Orion G. Harrison (M),DM10,"City of Plattsburgh Ward 3 2 ",0,1,0,3,4,0.47
DELEGATES TO NATIONAL CONVENTION 21st Congressional District,Orion G. Harrison (M),DM10,"City of Plattsburgh Ward 4 1 ",0,1,0,3,4,0.50
DELEGATES TO NATIONAL CONVENTION 21st Congressional District,Orion G. Harrison (M),DM10,"City of Plattsburgh Ward 4 2 ",0,2,0,0,2,0.25
DELEGATES TO NATIONAL CONVENTION 21st Congressional District,Orion G. Harrison (M),DM10,"City of Plattsburgh Ward 5 1 ",0,2,0,0,2,0.36
DELEGATES TO NATIONAL CONVENTION 21st Congressional District,Orion G. Harrison (M),DM10,"City of Plattsburgh Ward 5 2 ",0,3,0,0,3,0.37
DELEGATES TO NATIONAL CONVENTION 21st Congressional District,Orion G. Harrison (M),DM10,"City of Plattsburgh Ward 6 1 ",0,2,0,4,6,0.89
DELEGATES TO NATIONAL CONVENTION 21st Congressional District,Orion G. Harrison (M),DM10,"City of Plattsburgh Ward 6 2 ",0,0,0,2,2,0.61
DELEGATES TO NATIONAL CONVENTION 21st Congressional District,Orion G. Harrison (M),DM10,"Town of Altona 1 ",0,1,0,0,1,0.24
DELEGATES TO NATIONAL CONVENTION 21st Congressional District,Orion G. Harrison (M),DM10,"Town of AuSable 1 ",0,2,0,0,2,0.80
DELEGATES TO NATIONAL CONVENTION 21st Congressional District,Orion G. Harrison (M),DM10,"Town of AuSable 2 ",0,1,0,0,1,0.38
DELEGATES TO NATIONAL CONVENTION 21st Congressional District,Orion G. Harrison (M),DM10,"Town of Beekmantown 1 ",0,2,0,1,3,0.83
DELEGATES TO NATIONAL CONVENTION 21st Congressional District,Orion G. Harrison (M),DM10,"Town of Beekmantown 2 ",0,0,0,0,0,0.00
DELEGATES TO NATIONAL CONVENTION 21st Congressional District,Orion G. Harrison (M),DM10,"Town of Beekmantown 3 ",0,2,0,0,2,0.27
DELEGATES TO NATIONAL CONVENTION 21st Congressional District,Orion G. Harrison (M),DM10,"Town of Beekmantown 4 ",0,2,0,1,3,0.78
DELEGATES TO NATIONAL CONVENTION 21st Congressional District,Orion G. Harrison (M),DM10,"Town of Black Brook 1 ",0,0,0,1,1,0.37
DELEGATES TO NATIONAL CONVENTION 21st Congressional District,Orion G. Harrison (M),DM10,"Town of Black Brook 2 ",0,0,0,0,0,0.00
DELEGATES TO NATIONAL CONVENTION 21st Congressional District,Orion G. Harrison (M),DM10,"Town of Champlain 1 ",0,1,0,2,3,0.78
DELEGATES TO NATIONAL CONVENTION 21st Congressional District,Orion G. Harrison (M),DM10,"Town of Champlain 2 ",0,0,0,1,1,0.19
DELEGATES TO NATIONAL CONVENTION 21st Congressional District,Orion G. Harrison (M),DM10,"Town of Champlain 3 ",0,1,0,1,2,0.45
DELEGATES TO NATIONAL CONVENTION 21st Congressional District,Orion G. Harrison (M),DM10,"Town of Chazy 1 ",0,0,0,1,1,0.20
DELEGATES TO NATIONAL CONVENTION 21st Congressional District,Orion G. Harrison (M),DM10,"Town of Chazy 2 ",0,4,0,1,5,1.14
DELEGATES TO NATIONAL CONVENTION 21st Congressional District,Orion G. Harrison (M),DM10,"Town of Clinton 1 ",0,0,0,0,0,0.00
DELEGATES TO NATIONAL CONVENTION 21st Congressional District,Orion G. Harrison (M),DM10,"Town of Dannemora 1 ",0,0,0,3,3,3.75
DELEGATES TO NATIONAL CONVENTION 21st Congressional District,Orion G. Harrison (M),DM10,"Town of Dannemora 2 ",0,0,0,1,1,0.79
DELEGATES TO NATIONAL CONVENTION 21st Congressional District,Orion G. Harrison (M),DM10,"Town of Dannemora 3 ",0,0,0,1,1,0.54
DELEGATES TO NATIONAL CONVENTION 21st Congressional District,Orion G. Harrison (M),DM10,"Town of Ellenburg 1 ",0,1,0,0,1,0.28
DELEGATES TO NATIONAL CONVENTION 21st Congressional District,Orion G. Harrison (M),DM10,"Town of Mooers 1 ",0,2,0,2,4,1.19
DELEGATES TO NATIONAL CONVENTION 21st Congressional District,Orion G. Harrison (M),DM10,"Town of Mooers 2 ",0,1,0,0,1,0.71
DELEGATES TO NATIONAL CONVENTION 21st Congressional District,Orion G. Harrison (M),DM10,"Town of Peru 1 ",0,1,0,0,1,0.27
DELEGATES TO NATIONAL CONVENTION 21st Congressional District,Orion G. Harrison (M),DM10,"Town of Peru 2 ",0,4,0,0,4,0.73
DELEGATES TO NATIONAL CONVENTION 21st Congressional District,Orion G. Harrison (M),DM10,"Town of Peru 3 ",0,0,0,1,1,0.50
DELEGATES TO NATIONAL CONVENTION 21st Congressional District,Orion G. Harrison (M),DM10,"Town of Peru 4 ",0,2,0,0,2,0.37
DELEGATES TO NATIONAL CONVENTION 21st Congressional District,Orion G. Harrison (M),DM10,"Town of Plattsburgh 1 ",0,1,0,0,1,0.27
DELEGATES TO NATIONAL CONVENTION 21st Congressional District,Orion G. Harrison (M),DM10,"Town of Plattsburgh 2 ",0,2,0,0,2,0.42
DELEGATES TO NATIONAL CONVENTION 21st Congressional District,Orion G. Harrison (M),DM10,"Town of Plattsburgh 3 ",0,1,0,1,2,0.30
DELEGATES TO NATIONAL CONVENTION 21st Congressional District,Orion G. Harrison (M),DM10,"Town of Plattsburgh 4 ",0,0,0,0,0,0.00
DELEGATES TO NATIONAL CONVENTION 21st Congressional District,Orion G. Harrison (M),DM10,"Town of Plattsburgh 5 ",0,0,0,0,0,0.00
DELEGATES TO NATIONAL CONVENTION 21st Congressional District,Orion G. Harrison (M),DM10,"Town of Plattsburgh 6 ",0,1,0,1,2,0.22
DELEGATES TO NATIONAL CONVENTION 21st Congressional District,Orion G. Harrison (M),DM10,"Town of Plattsburgh 7 ",0,2,0,0,2,0.58
DELEGATES TO NATIONAL CONVENTION 21st Congressional District,Orion G. Harrison (M),DM10,"Town of Saranac 1 ",0,1,0,1,2,0.46
DELEGATES TO NATIONAL CONVENTION 21st Congressional District,Orion G. Harrison (M),DM10,"Town of Saranac 2 ",0,0,0,0,0,0.00
DELEGATES TO NATIONAL CONVENTION 21st Congressional District,Orion G. Harrison (M),DM10,"Town of Saranac 3 ",0,0,0,0,0,0.00
DELEGATES TO NATIONAL CONVENTION 21st Congressional District,Orion G. Harrison (M),DM10,"Town of Schuyler Falls 1 ",0,0,0,0,0,0.00
DELEGATES TO NATIONAL CONVENTION 21st Congressional District,Orion G. Harrison (M),DM10,"Town of Schuyler Falls 2 ",0,5,0,0,5,1.11
DELEGATES TO NATIONAL CONVENTION 21st Congressional District,Orion G. Harrison (M),DM10,"Town of Schuyler Falls 3 ",0,2,0,1,3,0.81
